age,ast,awards,blk,drb,efg_pct,fg,fg2,fg2_pct,fg2a,fg3,fg3_pct,fg3a,fg_pct,fga,ft,ft_pct,fta,games,games_started,mp,name_display,orb,pf,pos,pts,stl,team_name_abbr,tov,trb
24,686,"MVP-3,CPOY-6,AS,NBA1",38,588,.573,804,520,.573,908,284,.382,744,.487,1652,478,.786,608,70,70,2624,Luka DonÄiÄ,59,149,PG,2370,99,DAL,282,647
25,465,"MVP-2,DPOY-7,CPOY-3,AS,NBA1",67,350,.567,796,701,.576,1218,95,.353,269,.535,1487,567,.874,649,75,75,2553,Shai Gilgeous-Alexander,65,184,PG,2254,150,OKC,162,415
29,476,"MVP-4,DPOY-9,CPOY-12,AS,NBA1",79,645,.624,837,803,.645,1245,34,.274,124,.611,1369,514,.657,782,73,73,2567,Giannis Antetokounmpo,196,210,PF,2222,87,MIL,250,841
27,519,"MVP-5,CPOY-5,AS,NBA2",13,235,.543,790,579,.516,1122,211,.401,526,.479,1648,421,.847,497,77,77,2726,Jalen Brunson,43,144,PG,2212,70,NYK,186,278
28,708,"MVP-1,CPOY-4,AS,NBA1",68,753,.612,822,739,.626,1180,83,.359,231,.583,1411,358,.817,438,79,79,2737,Nikola JokiÄ,223,194,C,2085,108,DEN,237,976
22,405,"MVP-7,CPOY-8,AS,NBA2",42,378,.522,718,528,.515,1026,190,.357,532,.461,1558,423,.836,506,79,78,2770,Anthony Edwards,52,141,SG,2049,101,MIN,241,430
35,378,"MVP-9,AS,NBA2",91,454,.581,751,583,.567,1029,168,.413,407,.523,1436,362,.856,423,75,75,2791,Kevin Durant,41,133,PF,2032,69,PHO,244,495
25,364,"MVP-6,CPOY-9,AS,NBA1",43,534,.552,672,443,.542,817,229,.376,609,.471,1426,414,.833,497,74,74,2645,Jayson Tatum,67,145,PF,1987,75,BOS,188,601
26,418,CPOY-12,31,273,.534,720,506,.522,969,214,.369,580,.465,1549,312,.738,423,74,74,2659,De'Aaron Fox,67,193,PG,1966,150,SAC,194,340
35,379,"CPOY-1,AS,NBA3",28,293,.573,650,293,.515,569,357,.408,876,.450,1445,299,.923,324,74,74,2421,Stephen Curry,37,117,PG,1956,54,GSW,210,330
34,421,CPOY-2,45,297,.507,650,575,.509,1130,75,.333,225,.480,1355,522,.853,612,79,79,2989,DeMar DeRozan,43,161,SF,1897,90,CHI,135,340
30,266,"DPOY-4,AS,NBA2",178,722,.567,713,684,.582,1176,29,.271,107,.556,1283,421,.816,516,76,76,2700,Anthony Davis,239,177,C,1876,91,LAL,159,961
27,472,"AS,NBA3",28,252,.550,642,490,.552,887,152,.364,418,.492,1305,405,.886,457,68,68,2447,Devin Booker,56,206,PG,1841,61,PHO,178,308
39,589,"CPOY-10,AS,NBA3",38,457,.599,685,536,.592,906,149,.410,363,.540,1269,303,.750,404,71,71,2504,LeBron James,61,78,PF,1822,89,LAL,245,518
23,433,"MIP-1,AS",33,222,.524,638,426,.501,850,212,.373,569,.450,1419,328,.868,378,70,70,2626,Tyrese Maxey,36,151,PG,1816,69,PHI,116,258
21,431,AS,47,472,.497,640,521,.493,1056,119,.339,351,.455,1407,405,.725,559,80,80,2799,Paolo Banchero,82,153,PF,1804,71,ORL,247,554
33,508,"CPOY-11,AS",18,284,.510,541,321,.490,655,220,.354,622,.424,1277,473,.920,514,73,73,2579,Damian Lillard,36,134,PG,1775,72,MIL,193,320
27,502,,24,354,.528,672,471,.518,909,201,.363,554,.459,1463,208,.794,262,78,78,2783,Dejounte Murray,62,138,SG,1753,111,ATL,201,416
29,342,,25,426,.569,681,596,.581,1025,85,.346,246,.536,1271,290,.732,396,80,80,2657,Pascal Siakam,139,193,PF,1737,63,2TM,141,565
33,262,AS,37,351,.569,582,339,.523,648,243,.413,588,.471,1236,264,.907,291,74,74,2502,Paul George,37,202,PF,1671,113,LAC,153,388
32,244,"AS,NBA2",59,332,.585,610,470,.569,826,140,.417,336,.525,1162,253,.885,286,68,68,2330,Kawhi Leonard,84,97,SF,1613,111,LAC,119,416
27,249,AS,37,303,.557,627,482,.570,846,145,.354,410,.499,1256,211,.703,300,70,70,2343,Jaylen Brown,84,185,SF,1610,83,BOS,166,387
21,291,,28,382,.498,563,362,.498,727,201,.332,605,.423,1332,283,.804,352,82,82,2601,Jalen Green,41,115,SG,1610,66,HOU,191,423
27,299,,30,304,.521,564,344,.490,702,220,.372,592,.436,1294,258,.814,317,82,82,2854,Mikal Bridges,68,116,SF,1606,81,BRK,164,372
23,352,,47,284,.573,624,618,.574,1076,6,.333,18,.570,1094,347,.702,494,70,70,2207,Zion Williamson,122,159,PF,1601,77,NOP,193,406
27,673,"MVP-8,DPOY-10,NBA3",48,826,.609,634,601,.613,981,33,.379,87,.594,1068,292,.704,415,82,82,2928,Domantas Sabonis,294,250,C,1593,74,SAC,272,1120
28,296,,49,402,.521,608,457,.530,863,151,.336,450,.463,1313,186,.775,240,70,70,2281,Kyle Kuzma,62,153,PF,1553,37,WAS,192,464
20,274,"ROY-1,DPOY-2",254,594,.519,551,423,.534,792,128,.325,394,.465,1186,292,.796,367,71,71,2106,Victor Wembanyama,161,153,C,1522,88,SAS,260,755
23,405,,18,314,.534,541,332,.508,653,209,.376,556,.447,1209,218,.838,260,79,78,2881,Coby White,44,186,PG,1509,53,CHI,166,358
31,299,CPOY-7,28,246,.573,562,389,.548,710,173,.411,421,.497,1131,190,.905,210,58,58,2030,Kyrie Irving,44,112,SG,1487,74,DAL,106,290
24,154,,106,280,.494,516,399,.501,796,117,.320,366,.444,1162,337,.808,417,66,66,2124,Jaren Jackson Jr.,85,235,C,1486,80,MEM,160,365
22,192,,16,186,.503,526,382,.481,794,144,.364,396,.442,1190,286,.856,334,66,51,2075,Cam Thomas,28,138,SG,1482,45,BRK,124,214
27,333,AS,30,234,.545,503,321,.539,595,182,.368,494,.462,1089,275,.865,318,55,55,1942,Donovan Mitchell,46,118,SG,1463,101,CLE,154,280
25,383,,18,134,.549,506,378,.530,713,128,.394,325,.487,1038,318,.859,370,78,51,2075,Collin Sexton,71,154,SG,1458,62,UTA,165,205
25,231,,33,434,.527,559,402,.529,760,157,.349,450,.462,1210,174,.825,211,69,67,2581,Miles Bridges,71,118,SF,1449,65,CHO,138,505
22,269,,28,309,.525,528,434,.570,762,94,.281,334,.482,1096,271,.850,319,72,72,2337,Franz Wagner,72,168,SF,1421,76,ORL,137,381
22,464,,22,235,.500,524,405,.487,832,119,.355,335,.449,1167,238,.869,274,62,62,2074,Cade Cunningham,33,153,PG,1405,56,DET,212,268
23,752,"AS,NBA3",48,236,.570,500,305,.595,513,195,.364,535,.477,1048,194,.855,227,69,68,2224,Tyrese Haliburton,35,75,PG,1389,83,IND,159,271
25,583,AS,11,126,.516,433,258,.479,539,175,.373,469,.430,1008,348,.855,407,54,54,1942,Trae Young,23,109,PG,1389,72,ATL,235,149
33,176,,35,219,.551,490,222,.503,441,268,.387,692,.432,1133,127,.927,137,77,63,2284,Klay Thompson,35,127,SF,1375,50,GSW,117,254
33,254,,60,591,.522,586,494,.550,898,92,.294,313,.484,1211,106,.822,129,76,74,2610,Nikola VuÄeviÄ,210,190,C,1370,50,CHI,120,801
27,482,,36,208,.560,492,266,.497,535,226,.415,545,.456,1080,159,.828,192,76,69,2484,D'Angelo Russell,28,156,PG,1369,69,LAL,156,236
26,278,"DPOY-3,AS",66,578,.529,530,515,.528,975,15,.357,42,.521,1017,292,.755,387,71,71,2416,Bam Adebayo,159,159,C,1367,81,MIA,162,737
21,200,ROY-2,190,519,.598,505,376,.623,604,129,.370,349,.530,953,218,.793,275,82,82,2413,Chet Holmgren,129,197,C,1357,53,OKC,131,648
24,343,,25,180,.491,490,306,.492,622,184,.326,564,.413,1186,192,.877,219,78,66,2346,Jordan Poole,32,244,SG,1356,86,WAS,188,212
25,122,,53,459,.586,522,302,.575,525,220,.397,554,.484,1079,92,.836,110,81,81,2565,Michael Porter Jr.,106,148,SF,1356,42,DEN,92,565
22,322,CPOY-12,45,245,.592,536,433,.576,752,103,.427,241,.540,993,180,.814,221,71,71,2223,Jalen Williams,37,175,PF,1355,80,OKC,123,282
28,189,AS,41,421,.575,479,343,.550,624,136,.416,327,.504,951,255,.873,292,62,62,2026,Karl-Anthony Towns,94,204,PF,1349,43,MIN,177,515
31,247,6MOY-5,26,219,.537,471,231,.503,459,240,.374,641,.428,1100,151,.921,164,79,33,2401,Bogdan BogdanoviÄ,53,179,SG,1333,96,ATL,112,272
26,363,,40,281,.534,500,414,.534,775,86,.355,242,.492,1017,246,.801,307,64,64,2103,Brandon Ingram,43,145,SF,1332,50,NOP,163,324
21,312,,46,406,.553,527,494,.567,871,33,.297,111,.537,982,244,.693,352,63,63,2046,Alperen Sengun,183,211,C,1331,76,HOU,162,589
23,277,,23,234,.550,498,332,.544,610,166,.372,446,.472,1056,161,.801,201,68,62,2248,Devin Vassell,27,74,SG,1323,73,SAS,108,261
32,305,,41,247,.572,484,245,.492,498,239,.429,557,.459,1055,115,.827,139,66,66,2159,CJ McCollum,39,126,PG,1322,62,NOP,110,286
27,100,,144,420,.587,476,360,.615,585,116,.358,324,.524,909,245,.773,317,77,77,2076,Myles Turner,113,232,C,1313,39,IND,109,533
25,450,,25,295,.568,457,303,.583,520,154,.367,420,.486,940,232,.853,272,82,57,2629,Austin Reaves,57,153,SG,1300,66,LAL,174,352
21,175,ROY-3,42,255,.524,476,292,.495,590,184,.373,493,.440,1083,143,.827,173,74,68,2383,Brandon Miller,60,184,SF,1279,66,CHO,132,315
26,110,,26,327,.578,427,252,.559,451,175,.399,439,.480,890,249,.899,277,55,55,1820,Lauri Markkanen,122,100,PF,1278,50,UTA,77,449
25,210,DPOY-10,81,568,.634,519,519,.638,813,0,.000,6,.634,819,233,.742,314,77,77,2442,Jarrett Allen,243,147,C,1271,53,CLE,121,811
29,589,,59,245,.527,423,196,.454,432,227,.387,586,.416,1018,197,.860,229,73,73,2684,Fred VanVleet,33,183,PG,1270,101,HOU,126,278
27,216,,36,234,.584,445,162,.542,299,283,.401,705,.443,1004,86,.754,114,81,63,2360,Donte DiVincenzo,63,166,SG,1259,107,NYK,113,297
26,384,,39,200,.554,474,329,.510,645,145,.425,341,.481,986,157,.853,184,59,59,1861,Jamal Murray,42,104,PG,1250,57,DEN,125,242
34,298,,17,213,.537,396,336,.519,648,60,.414,145,.499,793,394,.858,459,60,60,2042,Jimmy Butler,105,68,PF,1246,79,MIA,102,318
29,342,,21,212,.518,442,293,.498,588,149,.363,410,.443,998,172,.869,198,61,60,2040,Terry Rozier,35,101,SG,1205,63,2TM,106,247
31,217,,46,373,.535,463,372,.537,693,91,.353,258,.487,951,187,.878,213,70,70,2368,Tobias Harris,80,115,PF,1204,70,PHI,93,453
34,614,,57,335,.541,352,166,.497,334,186,.381,488,.428,822,302,.878,344,72,72,2470,James Harden,34,127,PG,1192,77,LAC,185,369
22,363,AS,88,353,.528,447,346,.536,646,101,.341,296,.475,942,196,.781,251,60,60,2094,Scottie Barnes,141,118,SG,1191,75,TOR,165,494
21,163,,36,263,.560,456,403,.578,697,53,.321,165,.529,862,223,.746,299,74,46,1949,Jonathan Kuminga,92,169,PF,1188,55,GSW,122,355
21,296,,41,178,.492,417,293,.485,604,124,.336,369,.429,973,227,.749,303,77,61,2217,Jaden Ivey,86,204,SG,1185,57,DET,190,264
23,129,,59,314,.548,443,260,.560,464,183,.358,511,.454,975,103,.831,124,77,77,2588,Keegan Murray,106,205,SF,1172,79,SAC,64,420
23,193,,22,262,.547,436,346,.549,630,90,.360,250,.495,880,208,.715,291,58,58,1838,RJ Barrett,53,129,SG,1170,31,2TM,126,315
24,331,,10,242,.530,388,217,.471,461,171,.395,433,.434,894,209,.853,245,68,38,1985,Immanuel Quickley,17,119,SG,1156,50,2TM,101,259
28,115,,111,312,.589,388,278,.606,459,110,.375,293,.516,752,259,.858,302,57,57,1690,Kristaps PorziÅÄ£is,97,156,C,1145,42,BOS,89,409
31,139,6MOY-9,6,232,.510,392,181,.478,379,211,.353,597,.402,976,144,.852,169,79,12,2120,Tim Hardaway Jr.,22,106,SF,1139,42,DAL,69,254
29,152,,34,154,.516,383,272,.474,574,111,.402,276,.451,850,255,.817,312,54,54,1830,Jerami Grant,37,117,PF,1132,45,POR,116,191
28,104,6MOY-3,34,465,.562,466,366,.545,672,100,.407,246,.508,918,98,.790,124,82,4,2008,Bobby Portis,142,189,PF,1130,68,MIL,91,607
30,488,,17,203,.509,403,265,.474,559,138,.375,368,.435,927,178,.836,213,80,58,2486,Dennis SchrÃ¶der,39,164,PG,1122,63,2TM,153,242
25,370,"CPOY-12,6MOY-2",39,184,.526,396,248,.528,470,148,.350,423,.443,893,170,.829,205,72,0,1872,Malik Monk,28,156,SG,1110,45,SAC,150,212
29,377,DPOY-8,87,259,.578,387,191,.555,344,196,.396,495,.461,839,137,.901,152,73,73,2381,Derrick White,51,152,SG,1107,74,BOS,112,310
23,286,,36,456,.560,406,318,.560,568,88,.374,235,.506,803,202,.740,273,75,75,2257,Deni Avdija,84,185,SF,1102,60,WAS,160,540
29,229,AS,12,324,.518,395,319,.539,592,76,.311,244,.472,836,236,.781,302,46,46,1630,Julius Randle,99,125,PF,1102,25,NYK,159,423
24,106,6MOY-1,73,350,.576,406,237,.535,443,169,.414,408,.477,851,109,.736,148,81,14,1964,Naz Reid,73,172,C,1090,63,MIN,111,423
24,195,,20,282,.527,391,264,.533,495,127,.346,367,.454,862,175,.792,221,69,27,2038,Keldon Johnson,95,149,SF,1084,51,SAS,100,377
24,156,,16,195,.602,386,202,.643,314,184,.383,480,.486,794,114,.726,157,80,22,2067,Corey Kispert,30,141,SF,1070,41,WAS,98,225
31,102,DPOY-1,162,697,.661,406,406,.664,611,0,.000,3,.661,614,249,.638,390,76,76,2593,Rudy Gobert,285,238,C,1061,52,MIN,118,982
30,82,6MOY-4,22,179,.594,373,206,.536,384,167,.435,384,.486,768,143,.831,172,76,3,1990,Norman Powell,16,137,SG,1056,43,LAC,66,195
28,101,,47,247,.498,387,286,.517,553,101,.311,325,.441,878,174,.750,232,68,52,2055,Kelly Oubre Jr.,94,194,SF,1049,77,PHI,87,341
20,121,,61,477,.537,378,240,.530,453,138,.363,380,.454,833,150,.811,185,76,76,2424,Jabari Smith Jr.,139,200,PF,1044,52,HOU,89,616
24,255,,5,145,.523,360,204,.472,432,156,.385,405,.430,837,163,.916,178,46,46,1582,Anfernee Simons,22,98,SG,1039,23,POR,126,167
24,373,,7,122,.524,375,243,.501,485,132,.371,356,.446,841,146,.834,175,57,57,1901,Darius Garland,30,95,PG,1028,74,CLE,176,152
26,77,,61,418,.590,397,311,.605,514,86,.371,232,.532,746,147,.795,185,68,66,1901,John Collins,157,191,PF,1027,40,UTA,98,575
28,227,,45,247,.649,340,135,.570,237,205,.461,445,.499,682,129,.878,147,75,74,2513,Grayson Allen,48,157,SG,1014,69,PHO,95,295
28,259,,45,297,.584,398,358,.619,578,40,.290,138,.556,716,177,.658,269,73,73,2297,Aaron Gordon,174,142,PF,1013,56,DEN,105,471
31,236,,42,208,.565,371,152,.539,282,219,.386,568,.436,850,52,.881,59,84,42,2160,Buddy Hield,61,169,SF,1013,70,2TM,103,269
31,173,,68,535,.585,402,365,.609,599,37,.308,120,.559,719,161,.785,205,82,82,1925,Jonas ValanÄiÅ«nas,186,218,C,1002,32,NOP,111,721
31,99,,12,182,.576,347,198,.571,347,149,.387,385,.474,732,157,.801,196,82,82,2381,Harrison Barnes,67,98,PF,1000,54,SAC,58,249
25,230,,22,149,.552,360,223,.536,416,137,.381,360,.464,776,140,.870,161,42,42,1443,Desmond Bane,36,120,SG,997,43,MEM,112,185
35,127,,189,292,.583,366,218,.621,351,148,.366,404,.485,755,110,.821,134,79,79,2411,Brook Lopez,117,191,C,990,43,MIL,79,409
21,386,,44,403,.523,402,320,.530,604,82,.337,243,.475,847,100,.806,124,80,80,2011,Josh Giddey,111,111,SG,986,51,OKC,168,514
20,332,,7,196,.482,319,172,.459,375,147,.334,440,.391,815,189,.848,223,75,44,2023,Keyonte George,15,91,PG,974,36,UTA,188,211
25,119,,10,163,.531,361,183,.464,394,178,.393,453,.426,847,74,.771,96,71,41,1994,Gary Trent Jr.,25,96,SG,974,77,TOR,47,188
30,265,,27,178,.582,377,276,.552,500,101,.430,235,.513,735,109,.813,134,53,53,1767,Bradley Beal,54,127,SG,964,52,PHO,131,232
29,346,,34,241,.487,345,237,.486,488,108,.325,332,.421,820,154,.766,201,68,10,1958,Caris LeVert,39,121,SG,952,76,CLE,117,280
22,205,DPOY-10,47,181,.578,336,183,.556,329,153,.397,385,.471,714,118,.756,156,75,75,2025,Jalen Suggs,48,205,SG,943,106,ORL,132,229
31,277,,6,139,.469,337,246,.485,507,91,.294,309,.413,816,177,.881,201,55,19,1682,Jordan Clarkson,49,81,SG,942,35,UTA,146,188
28,119,,41,213,.511,353,262,.498,526,91,.358,254,.453,780,142,.751,189,71,59,1920,Andrew Wiggins,108,147,SF,939,42,GSW,87,321
25,141,,59,326,.518,354,222,.558,398,132,.320,413,.436,811,99,.683,145,73,45,2221,P.J. Washington,85,169,PF,939,72,2TM,96,411
23,236,,37,247,.496,332,239,.490,488,93,.338,275,.435,763,180,.826,218,81,0,1817,Cole Anthony,64,175,PG,937,64,ORL,126,311
24,242,,36,162,.583,360,241,.568,424,119,.403,295,.501,719,85,.810,105,76,37,2212,Ayo Dosunmu,54,166,SG,924,68,CHI,103,216
25,81,,25,236,.609,363,265,.597,444,98,.422,232,.537,676,99,.739,134,68,39,1826,Rui Hachimura,58,101,PF,923,41,LAL,46,294
25,90,,42,433,.571,427,426,.576,739,1,.100,10,.570,749,65,.823,79,55,55,1784,Deandre Ayton,176,109,C,920,56,POR,99,609
28,119,,10,193,.515,329,196,.492,398,133,.359,370,.428,768,124,.844,147,72,72,2227,Dillon Brooks,53,241,SF,915,64,HOU,88,246
22,203,,47,414,.562,359,288,.574,502,71,.355,200,.511,702,107,.728,147,56,52,1889,Jalen Johnson,74,133,SF,896,67,ATL,101,488
26,87,,16,191,.547,304,187,.521,359,117,.385,304,.459,663,166,.847,196,57,37,1681,De'Andre Hunter,31,146,SF,891,40,ATL,83,222
27,108,,9,249,.598,320,96,.533,180,224,.413,542,.443,722,25,.714,35,79,77,2337,Malik Beasley,41,158,SG,889,59,MIL,54,290
22,195,"ROY-4,6MOY-9",20,203,.536,341,276,.558,495,65,.322,202,.489,697,142,.811,175,75,20,2113,Jaime Jaquez Jr.,82,167,SF,889,77,MIA,110,285
24,108,,49,212,.606,315,175,.581,301,140,.419,334,.496,635,107,.781,137,72,47,1995,Aaron Nesmith,63,241,SF,877,65,IND,64,275
24,188,,3,203,.531,324,192,.478,402,132,.396,333,.441,735,95,.856,111,42,40,1407,Tyler Herro,19,63,SG,875,30,MIA,93,222
29,192,,16,158,.589,304,117,.579,202,187,.395,473,.450,675,80,.889,90,68,36,1905,Duncan Robinson,15,163,SF,875,46,MIA,95,173
36,449,,17,181,.595,294,115,.481,239,179,.442,405,.457,644,102,.911,112,76,76,2193,Mike Conley,37,128,PG,869,88,MIN,102,218
19,336,,13,141,.440,307,220,.416,529,87,.325,268,.385,797,167,.819,204,62,32,1765,Scoot Henderson,53,195,PG,868,48,POR,212,194
26,96,,21,230,.636,332,294,.673,437,38,.330,115,.601,552,166,.814,204,80,1,1415,Moritz Wagner,117,160,C,868,39,ORL,97,347
34,97,6MOY-9,5,130,.551,309,176,.507,347,133,.398,334,.454,681,117,.785,149,57,27,1478,Bojan BogdanoviÄ,22,95,PF,868,30,2TM,101,152
24,92,,11,244,.497,290,177,.522,339,113,.316,358,.416,697,170,.837,203,63,51,2062,Saddiq Bey,167,88,SF,863,51,ATL,54,411
20,249,,40,339,.483,340,270,.492,549,70,.308,227,.438,776,111,.771,144,74,73,2193,Jeremy Sochan,137,168,PF,861,62,SAS,140,476
24,113,,47,210,.557,288,132,.506,261,156,.394,396,.438,657,128,.826,155,79,79,2246,Luguentz Dort,74,228,SF,860,72,OKC,74,284
33,333,DPOY-6,53,289,.581,331,193,.526,367,138,.429,322,.480,689,60,.833,72,69,69,2263,Jrue Holiday,84,108,PG,860,61,BOS,124,373
21,119,,14,174,.507,296,216,.481,449,80,.374,214,.446,663,184,.821,224,59,19,1538,Bennedict Mathurin,60,117,SF,856,35,IND,97,234
27,283,,29,272,.533,304,136,.546,249,168,.351,479,.418,728,77,.794,97,70,70,2239,Max Strus,66,170,SF,853,64,CLE,112,338
25,128,,43,235,.661,332,230,.706,326,102,.403,253,.573,579,77,.770,100,82,28,1730,Obi Toppin,85,143,PF,843,47,IND,69,320
23,124,,28,238,.579,275,106,.602,176,169,.380,445,.443,621,123,.815,151,57,23,1690,Trey Murphy III,42,70,SF,842,51,NOP,34,280
24,147,,146,513,.630,366,365,.633,577,1,.200,5,.629,582,108,.551,196,71,71,2116,Nic Claxton,193,175,C,841,46,BRK,93,706
20,147,,47,517,.619,349,349,.623,560,0,.000,4,.619,564,143,.790,181,61,60,1777,Jalen Duren,192,192,C,841,33,DET,129,709
25,199,DPOY-5,62,198,.595,293,179,.568,315,114,.418,273,.498,588,137,.867,158,76,76,2321,Herbert Jones,74,224,SF,837,105,NOP,93,272
29,91,,106,441,.571,353,353,.572,617,0,.000,1,.571,618,130,.631,206,73,73,1883,Clint Capela,335,164,C,836,43,ATL,74,776
33,308,,13,122,.499,326,224,.475,472,102,.359,284,.431,756,79,.806,98,82,23,1817,Reggie Jackson,33,149,PG,833,44,DEN,106,155
29,301,,80,613,.528,320,298,.555,537,22,.244,90,.510,627,167,.640,261,76,76,2078,Jusuf NurkiÄ,224,254,C,829,81,PHO,175,837
32,292,,15,217,.566,317,223,.563,396,94,.381,247,.493,643,100,.833,120,55,55,1487,Khris Middleton,40,141,SF,828,51,MIL,127,257
25,115,,153,367,.725,348,348,.725,480,0,,0,.725,480,118,.674,175,74,66,1815,Daniel Gafford,195,227,PF,814,65,2TM,74,562
30,356,,22,175,.489,251,127,.467,272,124,.337,368,.392,640,169,.805,210,76,52,2152,Spencer Dinwiddie,30,138,PG,795,51,2TM,91,205
26,93,,83,430,.649,337,337,.649,519,0,,0,.649,519,120,.723,166,68,68,1794,Ivica Zubac,196,180,C,794,22,LAC,79,626
27,485,,18,159,.569,326,220,.537,410,106,.414,256,.489,666,32,.800,40,66,66,1933,Tyus Jones,20,48,PG,790,71,WAS,66,179
26,281,,6,195,.583,297,150,.593,253,147,.385,382,.468,635,46,.821,56,82,5,1825,Payton Pritchard,70,106,PG,787,39,BOS,61,265
22,160,,72,357,.600,320,298,.604,493,22,.373,59,.580,552,123,.719,171,50,50,1532,Evan Mobley,111,134,PF,785,45,CLE,90,468
25,174,,39,232,.560,276,150,.558,269,126,.375,336,.456,605,106,.757,140,76,43,2130,Grant Williams,86,226,PF,784,44,2TM,109,318
26,194,,52,252,.531,298,240,.552,435,58,.320,181,.484,616,122,.753,162,69,29,1526,Zach Collins,118,206,C,776,34,SAS,132,370
27,138,,15,196,.557,276,138,.519,266,138,.391,353,.446,619,86,.789,109,58,47,1599,Cameron Johnson,55,105,PF,776,49,BRK,57,251
24,478,,9,231,.558,303,239,.584,409,64,.335,191,.505,600,101,.856,118,77,48,2138,Tre Jones,58,92,PG,771,78,SAS,116,289
30,98,,18,256,.567,284,135,.572,236,149,.376,396,.449,632,51,.850,60,82,10,1831,Georges Niang,22,192,PF,768,30,CLE,72,278
30,183,,42,152,.566,270,145,.520,279,125,.406,308,.460,587,101,.894,113,76,76,2402,Kentavious Caldwell-Pope,31,151,SG,766,98,DEN,75,183
32,347,,30,303,.616,276,216,.632,342,60,.387,155,.555,497,150,.833,180,78,27,1759,Kelly Olynyk,108,230,C,762,74,2TM,152,411
28,331,,23,547,.493,295,215,.511,421,80,.310,258,.434,679,91,.791,115,81,42,2707,Josh Hart,128,171,SF,761,75,NYK,118,675
23,101,,42,168,.557,307,221,.592,373,86,.337,255,.489,628,57,.722,79,72,71,2105,Jaden McDaniels,56,219,SF,757,63,MIN,87,224
35,306,6MOY-7,23,250,.486,301,259,.509,509,42,.273,154,.454,663,110,.688,160,68,11,1529,Russell Westbrook,93,121,PG,754,74,LAC,144,343
35,139,,30,106,.565,274,124,.561,221,150,.378,397,.443,618,51,.797,64,68,24,1893,Eric Gordon,16,79,SG,749,66,PHO,73,122
26,107,,36,161,.577,282,180,.581,310,102,.382,267,.489,577,67,.753,89,50,50,1702,OG Anunoby,47,119,SF,733,68,2TM,81,208
31,390,6MOY-7,8,155,.572,330,312,.568,549,18,.409,44,.556,593,49,.790,62,71,4,1291,T.J. McConnell,36,79,PG,727,72,IND,108,191
27,192,,17,231,.523,278,225,.538,418,53,.323,164,.478,582,117,.824,142,67,44,1866,Bruce Brown,53,148,SG,726,59,2TM,86,284
29,247,DPOY-10,70,211,.593,253,117,.563,208,136,.408,333,.468,541,73,.760,96,71,57,2040,Alex Caruso,62,181,SG,715,120,CHI,102,273
26,82,,25,231,.623,249,52,.559,93,197,.424,465,.446,558,17,.895,19,79,13,1741,Sam Hauser,45,99,SF,712,40,BOS,32,276
19,59,,24,143,.519,241,139,.502,277,102,.357,286,.428,563,115,.752,153,48,18,1233,GG Jackson II,53,64,PF,699,28,MEM,65,196
29,119,,35,209,.566,253,112,.519,216,141,.396,356,.442,572,50,.735,68,78,49,2108,Taurean Prince,21,146,PF,697,58,LAL,73,230
28,101,,23,182,.582,252,118,.551,214,134,.401,334,.460,548,54,.818,66,66,43,1644,Simone Fontecchio,64,110,SF,692,44,2TM,68,246
20,156,,8,120,.506,271,178,.494,360,93,.347,268,.432,628,55,.873,63,75,29,1594,Malaki Branham,28,94,PG,690,27,SAS,91,148
32,88,,12,126,.478,210,86,.360,239,124,.376,330,.369,569,145,.868,167,66,1,1212,Alec Burks,24,75,SG,689,28,2TM,48,150
20,273,ROY-5,14,309,.529,271,181,.499,363,90,.385,234,.454,597,50,.633,79,74,28,1968,Brandin Podziemski,118,122,SG,682,61,GSW,88,427
30,37,,48,443,.556,267,267,.560,477,0,.000,3,.556,480,129,.592,218,79,10,1351,Andre Drummond,265,140,C,663,73,CHI,81,708
27,119,,15,167,.587,254,183,.633,289,71,.348,204,.515,493,79,.832,95,75,71,1873,Terance Mann,87,145,SG,658,43,LAC,48,254
26,75,,51,168,.566,239,157,.613,256,82,.343,239,.483,495,97,.713,136,76,66,1783,Derrick Jones Jr.,82,121,SF,657,53,DAL,65,250
25,204,,42,132,.560,236,105,.517,203,131,.391,335,.439,538,52,.800,65,82,20,1921,Nickeil Alexander-Walker,35,143,SG,655,64,MIN,76,167
25,166,,23,186,.553,248,125,.571,219,123,.361,341,.443,560,36,.766,47,64,59,1562,Kevin Huerter,38,135,SG,655,45,SAC,53,224
23,138,,54,280,.528,247,141,.534,264,106,.349,304,.435,568,54,.621,87,61,35,1618,Santi Aldama,72,89,PF,654,43,MEM,69,352
26,54,,74,367,.691,260,260,.693,375,0,.000,1,.691,376,132,.737,179,67,51,1759,Nick Richards,172,176,C,652,26,CHO,73,539
23,132,,34,139,.577,235,151,.570,265,84,.391,215,.490,480,93,.679,137,69,42,1887,Isaac Okoro,67,140,SF,647,57,CLE,54,206
28,143,,29,207,.504,241,160,.489,327,81,.349,232,.431,559,77,.778,99,64,23,1756,Caleb Martin,74,126,SF,640,47,MIA,77,281
21,71,,22,357,.500,234,193,.522,370,41,.295,139,.460,509,129,.754,171,72,23,1700,Jabari Walker,151,173,SF,638,42,POR,66,508
24,99,,22,148,.609,222,75,.568,132,147,.416,353,.458,485,45,.865,52,78,1,1445,Isaiah Joe,32,87,SG,636,46,OKC,47,180
24,280,,6,105,.557,260,199,.567,351,61,.357,171,.498,522,45,.804,56,68,47,1697,Andrew Nembhard,36,143,PG,626,63,IND,101,141
27,67,,38,157,.549,230,142,.559,254,88,.359,245,.461,499,69,.742,93,68,20,1214,Duop Reath,93,161,C,617,33,POR,52,250
30,219,,44,317,.542,214,58,.496,117,156,.370,422,.397,539,24,.686,35,79,14,1954,Royce O'Neale,60,174,SF,608,59,2TM,73,377
24,95,,28,269,.600,223,159,.626,254,64,.374,171,.525,425,93,.694,134,55,48,1406,Wendell Carter Jr.,112,121,C,603,35,ORL,68,381
23,63,,38,225,.670,234,173,.689,251,61,.424,144,.592,395,72,.692,104,61,14,1047,Jalen Smith,112,124,C,601,17,IND,44,337
22,132,,35,227,.525,222,159,.498,319,63,.384,164,.460,483,93,.694,134,82,4,1655,Christian Braun,79,137,SG,600,42,DEN,55,306
24,109,,84,295,.561,259,238,.563,423,21,.368,57,.540,480,61,.718,85,82,24,1590,Paul Reed,193,198,C,600,67,PHI,67,488
21,163,,38,261,.545,239,231,.595,388,8,.138,58,.536,446,106,.684,155,62,23,1388,Amen Thompson,148,141,SF,592,78,HOU,90,409
23,236,,12,114,.516,219,129,.474,272,90,.375,240,.428,512,58,.879,66,71,11,1351,Marcus Sasser,11,103,PG,586,44,DET,90,125
24,55,,33,182,.597,239,230,.597,385,9,.391,23,.586,408,96,.762,126,50,25,1053,Marvin Bagley III,130,81,C,583,20,2TM,59,312
25,188,,85,382,.645,235,234,.646,362,1,.333,3,.644,365,111,.707,157,75,49,1896,Isaiah Hartenstein,244,210,C,582,87,NYK,93,626
30,107,,38,208,.535,215,98,.560,175,117,.348,336,.421,511,33,.717,46,68,56,1934,Dorian Finney-Smith,109,150,PF,580,56,BRK,59,317
19,33,,17,136,.539,212,133,.538,247,79,.359,220,.454,467,76,.679,112,47,2,880,Cam Whitmore,44,64,SF,579,30,HOU,46,180
29,205,,11,96,.541,208,104,.486,214,104,.390,267,.432,481,58,.866,67,78,10,1304,Cameron Payne,21,126,PG,578,42,2TM,66,117
25,74,,20,114,.528,208,104,.471,221,104,.384,271,.423,492,45,.763,59,58,0,1011,Lonnie Walker IV,13,71,SG,565,32,BRK,51,127
24,97,,68,296,.529,235,209,.562,372,26,.268,97,.501,469,69,.616,112,74,18,1624,Precious Achiuwa,191,143,PF,565,46,2TM,83,487
37,168,,62,331,.640,214,106,.658,161,108,.419,258,.511,419,26,.867,30,65,33,1740,Al Horford,82,93,C,562,38,BOS,48,413
23,114,,7,69,.572,205,96,.511,188,109,.410,266,.452,454,43,.860,50,68,14,1328,Miles McBride,31,108,PG,562,50,NYK,30,100
23,74,,60,231,.642,223,200,.676,296,23,.333,69,.611,365,92,.793,116,55,8,1405,Onyeka Okongwu,145,162,C,561,26,ATL,45,376
20,120,,37,135,.602,217,119,.572,208,98,.419,234,.491,442,29,.784,37,82,13,1692,Cason Wallace,52,129,SG,561,76,OKC,45,187
24,127,,20,137,.463,202,143,.475,301,59,.296,199,.404,500,94,.783,120,54,9,1047,Dalano Banton,41,64,PG,557,33,2TM,77,178
21,120,,59,273,.505,232,211,.575,367,21,.186,113,.483,480,71,.597,119,63,38,1583,Ausar Thompson,129,175,SF,556,68,DET,84,402
28,127,,76,283,.656,248,248,.656,378,0,,0,.656,378,59,.551,107,50,50,1319,Jakob Poeltl,146,149,C,555,35,TOR,77,429
25,86,,19,126,.645,212,150,.598,251,62,.492,126,.562,377,56,.789,71,78,4,1228,Aaron Wiggins,60,91,SG,542,56,OKC,56,186
23,82,,76,206,.702,233,233,.704,331,0,.000,1,.702,332,74,.561,132,68,16,1130,Trayce Jackson-Davis,135,108,PF,540,29,GSW,49,341
21,57,,24,131,.548,194,122,.555,220,72,.360,200,.462,420,73,.785,93,66,9,1156,Moses Moody,65,90,SG,533,42,GSW,44,196
38,393,,6,207,.525,206,128,.498,257,78,.371,210,.441,467,43,.827,52,58,18,1531,Chris Paul,18,108,PG,533,70,GSW,76,225
19,110,,48,200,.509,188,124,.502,247,64,.346,185,.435,432,92,.702,131,63,15,1715,Bilal Coulibaly,56,137,SF,532,57,WAS,87,256
21,86,,88,202,.516,208,163,.553,295,45,.296,152,.465,447,71,.670,106,80,4,1488,Peyton Watson,56,143,SF,532,42,DEN,58,258
21,109,,4,111,.492,195,114,.447,255,81,.362,224,.407,479,59,.776,76,73,7,989,Jaden Hardy,20,80,SG,530,22,DAL,62,131
23,87,,33,204,.516,197,139,.523,266,58,.337,172,.450,438,75,.758,99,70,49,1739,Toumani Camara,139,174,PF,527,66,POR,84,343
21,70,,7,119,.501,174,65,.411,158,109,.366,298,.382,456,67,.838,80,67,10,1160,Jordan Hawkins,29,72,SG,524,19,NOP,40,148
23,175,,34,231,.550,169,90,.529,170,79,.378,209,.446,379,104,.800,130,52,33,1436,Vince Williams Jr.,59,135,SG,521,47,MEM,92,290
22,60,,154,316,.660,229,225,.680,331,4,.211,19,.654,350,56,.602,93,64,22,1493,Walker Kessler,165,132,C,518,30,UTA,66,481
23,177,,19,100,.460,184,124,.438,283,60,.330,182,.396,465,88,.807,109,51,11,1009,Talen Horton-Tucker,21,94,PG,516,45,UTA,65,121
29,144,,10,210,.562,181,107,.560,191,74,.376,197,.466,388,79,.849,93,64,9,1098,Dario Å ariÄ,73,112,C,515,31,GSW,78,283
27,140,,6,100,.547,186,102,.510,200,84,.387,217,.446,417,58,.921,63,78,1,1269,Aaron Holiday,23,125,PG,514,42,HOU,53,123
20,68,,2,105,.524,189,101,.495,204,88,.365,241,.425,445,44,.863,51,60,17,1268,Gradey Dick,27,87,SG,510,34,TOR,50,132
37,70,,31,132,.529,167,114,.553,206,53,.331,160,.456,366,122,.819,149,78,6,1307,Jeff Green,46,100,PF,509,16,HOU,46,178
30,331,,47,213,.472,199,188,.488,385,11,.229,48,.460,433,97,.708,137,79,10,1782,Kyle Anderson,60,128,PF,506,71,MIN,91,273
22,103,,42,164,.534,164,63,.504,125,101,.365,277,.408,402,75,.815,92,74,59,1468,Julian Champagnie,42,77,SF,504,48,SAS,57,206
22,73,,38,231,.575,186,119,.575,207,67,.383,175,.487,382,64,.753,85,46,45,1423,Isaiah Stewart,74,99,PF,503,17,DET,66,305
33,158,,13,143,.510,187,150,.479,313,37,.411,90,.464,403,89,.742,120,51,28,1245,Gordon Hayward,38,67,SF,500,40,2TM,66,181
28,119,,11,155,.591,184,98,.601,163,86,.389,221,.479,384,35,.673,52,72,3,1269,Cedi Osman,25,107,SF,489,36,SAS,47,180
37,253,,21,160,.562,163,65,.512,127,98,.392,250,.432,377,63,.840,75,60,55,1690,Kyle Lowry,34,146,PG,487,59,2TM,85,194
35,115,,10,279,.557,158,74,.643,115,84,.344,244,.440,359,85,.787,108,55,5,924,Kevin Love,59,97,PF,485,18,MIA,48,338
27,108,,4,98,.584,158,15,.385,39,143,.404,354,.402,393,26,.929,28,61,1,1069,Sam Merrill,22,72,SG,485,19,CLE,19,120
19,60,ROY-6,77,243,.747,221,221,.752,294,0,.000,2,.747,296,41,.506,81,55,42,1294,Dereck Lively II,135,144,C,483,36,DAL,50,378
33,332,,47,322,.566,185,134,.551,243,51,.395,129,.497,372,54,.730,74,55,52,1490,Draymond Green,76,166,PF,475,55,GSW,135,398
23,130,,9,144,.575,179,107,.572,187,72,.385,187,.479,374,39,.684,57,57,33,1505,Josh Green,40,107,SG,469,47,DAL,60,184
26,128,,12,187,.542,170,112,.516,217,58,.387,150,.463,367,68,.791,86,66,1,1257,Naji Marshall,53,91,SF,466,49,NOP,65,240
26,76,,14,119,.571,166,96,.571,168,70,.380,184,.472,352,61,.859,71,70,13,1460,Amir Coffey,29,102,SF,463,41,LAC,33,148
23,83,,44,142,.483,178,116,.523,222,62,.294,211,.411,433,37,.661,56,78,28,1641,Ochai Agbaji,74,117,SG,455,47,2TM,64,216
35,212,,31,190,.497,158,97,.490,198,61,.337,181,.417,379,74,.822,90,73,13,1462,Patrick Beverley,49,128,PG,451,43,2TM,65,239
22,54,,39,226,.613,187,187,.617,303,0,.000,2,.613,305,72,.706,102,63,6,1091,James Wiseman,110,141,C,446,12,DET,66,336
23,81,,19,142,.571,164,137,.564,243,27,.397,68,.527,311,77,.794,97,63,2,856,Trendon Watford,52,106,PF,432,23,BRK,63,194
22,66,,33,120,.525,159,100,.474,211,59,.399,148,.443,359,52,.788,66,43,30,1174,Patrick Williams,46,87,PF,429,40,CHI,57,166
31,161,,19,188,.553,151,69,.633,109,82,.345,238,.435,347,44,.759,58,76,3,1676,Pat Connaughton,51,99,SF,428,40,MIL,49,239
28,157,,5,124,.621,161,108,.557,194,53,.491,108,.533,302,53,.779,68,55,17,1088,Dante Exum,25,85,PG,428,22,DAL,49,149
30,105,,14,103,.539,154,88,.561,157,66,.347,190,.444,347,51,.944,54,43,6,1103,Josh Richardson,18,76,SG,425,24,MIA,36,121
22,80,,11,158,.462,165,117,.478,245,48,.293,164,.403,409,47,.691,68,65,13,1177,David Roddy,53,72,PF,425,27,2TM,57,211
30,262,,7,74,.488,159,116,.537,216,43,.279,154,.430,370,61,.813,75,60,21,1176,Vasilije MiciÄ,14,68,PG,422,31,2TM,99,88
22,75,,9,145,.474,150,92,.487,189,58,.307,189,.397,378,62,.827,75,51,15,1038,Ziaire Williams,35,85,SF,420,36,MEM,66,180
28,72,,19,196,.576,143,59,.578,102,84,.384,219,.445,321,49,.700,70,58,0,1158,Trey Lyles,61,86,PF,419,17,SAC,38,257
22,85,,44,228,.578,168,164,.588,279,4,.267,15,.571,294,75,.610,123,61,1,921,Day'Ron Sharpe,161,131,C,415,24,BRK,70,389
27,70,,30,145,.581,153,77,.562,137,76,.396,192,.465,329,23,.639,36,66,26,1366,Haywood Highsmith,65,117,PF,405,53,MIA,34,210
25,117,6MOY-6,15,103,.525,142,64,.464,138,78,.377,207,.412,345,35,.673,52,56,0,1028,Jose Alvarado,25,89,PG,397,59,NOP,40,128
26,30,6MOY-9,70,187,.584,146,104,.598,174,42,.375,112,.510,286,59,.720,82,58,2,914,Jonathan Isaac,73,64,PF,393,43,ORL,27,260
22,50,,61,144,.665,155,155,.677,229,0,.000,4,.665,233,73,.716,102,59,3,771,Isaiah Jackson,94,137,C,383,34,IND,39,238
22,165,,3,129,.533,145,98,.516,190,47,.373,126,.459,316,45,.763,59,41,28,987,Tre Mann,20,48,PG,382,51,2TM,65,149
25,130,,8,93,.505,136,80,.513,156,56,.331,169,.418,325,52,.732,71,69,0,876,Malachi Flynn,21,66,PG,380,38,3TM,63,114
26,63,,61,219,.607,152,149,.596,250,3,1.000,3,.601,253,72,.774,93,75,6,1169,Drew Eubanks,103,115,C,379,27,PHO,61,322
25,134,,3,76,.540,146,89,.539,165,57,.361,158,.452,323,30,.714,42,72,4,1101,Davion Mitchell,19,85,PG,379,17,SAC,43,95
23,80,,21,139,.463,145,96,.525,183,49,.268,183,.396,366,37,.661,56,62,29,1348,Kris Murray,85,92,SF,376,53,POR,55,224
31,61,,51,159,.577,156,130,.586,222,26,.366,71,.532,293,38,.760,50,60,3,1015,Daniel Theis,85,127,C,376,21,2TM,42,244
29,87,,14,67,.569,131,55,.598,92,76,.371,205,.441,297,34,.756,45,54,27,1297,Gary Harris,24,91,SG,372,49,ORL,31,91
26,203,,12,114,.482,147,115,.502,229,32,.294,109,.435,338,43,.741,58,56,2,1059,Dennis Smith Jr.,50,121,PG,369,68,BRK,68,164
25,155,,18,165,.424,141,99,.411,241,42,.298,141,.369,382,44,.746,59,57,12,1055,Jordan Goodwin,88,76,PG,368,48,2TM,56,253
25,62,,13,121,.535,138,94,.560,168,44,.336,131,.462,299,44,.830,53,52,1,712,Jordan Nwora,28,48,SF,364,26,2TM,53,149
23,66,,7,85,.495,122,41,.466,88,81,.338,240,.372,328,34,.756,45,51,18,1025,Quentin Grimes,15,75,SG,359,35,2TM,28,100
28,94,,16,49,.484,138,61,.466,131,77,.329,234,.378,365,4,.571,7,72,0,1004,Jevon Carter,11,71,PG,357,37,CHI,36,60
29,254,,28,139,.535,147,106,.525,202,41,.369,111,.470,313,22,.688,32,66,32,1249,Kris Dunn,50,135,PG,357,68,UTA,79,189
20,164,,25,174,.514,139,97,.551,176,42,.311,135,.447,311,34,.642,53,61,16,1358,Dyson Daniels,62,101,PG,354,85,NOP,59,236
26,90,,49,106,.524,126,46,.535,86,80,.346,231,.397,317,22,.759,29,65,19,1487,Matisse Thybulle,30,93,SF,354,113,POR,40,136
20,90,,14,167,.568,127,62,.525,118,65,.399,163,.452,281,33,.702,47,46,38,896,Nikola JoviÄ,25,82,PF,352,25,MIA,42,192
32,70,,2,49,.599,123,29,.527,55,94,.410,229,.433,284,11,.579,19,64,0,904,Doug McDermott,10,64,SF,351,16,2TM,28,59
31,113,,19,213,.629,138,111,.631,176,27,.415,65,.573,241,47,.770,61,61,0,1216,Larry Nance Jr.,94,98,C,350,61,NOP,49,307
28,49,,33,215,.532,123,88,.587,150,35,.307,114,.466,264,66,.702,94,50,1,872,Christian Wood,39,72,PF,347,16,LAL,50,254
25,120,,15,82,.479,154,150,.487,308,4,.222,18,.472,326,23,.697,33,43,18,910,Markelle Fultz,56,65,PG,335,42,ORL,50,138
28,67,,61,143,.702,142,141,.698,202,1,1.000,1,.700,203,49,.907,54,63,7,983,Luke Kornet,118,77,C,334,23,BOS,21,261
27,133,,29,276,.597,139,139,.599,232,0,.000,1,.597,233,56,.675,83,74,36,1195,Kevon Looney,143,155,C,334,28,GSW,50,419
26,46,,16,153,.561,123,95,.633,150,28,.298,94,.504,244,58,.906,64,51,12,859,Chimezie Metu,41,71,C,332,43,2TM,52,194
26,54,,10,46,.527,118,65,.556,117,53,.338,157,.431,274,38,.826,46,46,5,726,Landry Shamet,16,76,SG,327,25,WAS,30,62
27,37,,8,75,.644,103,18,.545,33,85,.440,193,.456,226,34,.810,42,66,5,992,Garrison Mathews,17,115,SG,325,20,ATL,19,92
29,93,,9,148,.568,131,75,.540,139,56,.397,141,.468,280,7,.500,14,69,1,1029,Kenrich Williams,61,101,PF,325,38,OKC,32,209
31,23,,24,145,.578,110,79,.642,123,31,.330,94,.507,217,71,.772,92,50,0,705,Chris Boucher,62,68,PF,322,14,TOR,28,207
35,128,,38,178,.596,116,43,.606,71,73,.395,185,.453,256,15,.714,21,60,38,1529,Nicolas Batum,70,109,PF,320,48,2TM,40,248
20,91,,21,106,.540,115,78,.510,153,37,.394,94,.466,247,49,.613,80,69,33,1164,Anthony Black,33,110,PG,316,35,ORL,56,139
34,36,,13,111,.530,116,68,.469,145,48,.403,119,.439,264,36,.818,44,49,7,817,Marcus Morris,23,74,PF,316,15,2TM,30,134
33,66,,9,130,.530,114,56,.538,104,58,.349,166,.422,270,26,.722,36,50,25,1156,Jae Crowder,31,74,PF,312,38,MIL,23,161
24,79,,72,177,.608,126,124,.636,195,2,.143,14,.603,209,57,.655,87,62,33,957,Goga Bitadze,109,107,C,311,32,ORL,44,286
24,85,,29,92,.612,107,37,.578,64,70,.417,168,.461,232,26,.743,35,57,21,978,Keon Ellis,32,112,SG,310,51,SAC,37,124
33,58,,21,148,.550,108,48,.490,98,60,.392,153,.430,251,27,.750,36,53,14,1049,Torrey Craig,69,110,SF,303,30,CHI,32,217
23,33,,29,142,.720,126,126,.754,167,0,.000,8,.720,175,51,.622,82,70,5,877,Jaxson Hayes,69,123,C,303,34,LAL,43,211
21,51,,10,85,.513,101,67,.523,128,34,.333,102,.439,230,66,.776,85,59,14,882,Bryce McGowens,17,74,SG,302,21,CHO,30,102
19,59,,7,54,.500,113,50,.350,143,63,.432,146,.391,289,13,.867,15,51,0,729,Nick Smith Jr.,18,55,SG,302,10,CHO,39,72
36,203,,5,124,.590,99,29,.439,66,70,.435,161,.436,227,28,.824,34,68,0,1169,Joe Ingles,18,88,SF,296,43,ORL,67,142
27,43,,25,181,.584,96,17,.567,30,79,.391,202,.414,232,20,.769,26,54,32,1108,Dean Wade,37,93,PF,291,40,CLE,20,218
31,35,,12,52,.556,92,16,.471,34,76,.380,200,.393,234,30,.909,33,43,1,674,DÄvis BertÄns,9,56,PF,290,26,2TM,18,61
22,205,,20,108,.452,117,95,.455,209,22,.297,74,.413,283,33,.660,50,42,31,1008,Killian Hayes,11,75,PG,289,36,DET,51,119
23,118,,15,88,.535,116,104,.536,194,12,.353,34,.509,228,41,.732,56,51,6,649,Craig Porter Jr.,21,40,PG,285,21,CLE,45,109
20,60,,17,127,.515,103,61,.496,123,42,.356,118,.427,241,36,.783,46,67,7,944,Max Christie,15,57,SG,284,20,LAL,35,142
25,77,,44,141,.470,121,101,.510,198,20,.247,81,.434,279,22,.440,50,54,15,974,Xavier Tillman Sr.,70,75,PF,284,51,2TM,34,211
25,46,,28,134,.583,109,109,.596,183,0,.000,4,.583,187,64,.667,96,45,2,682,Bruno Fernando,59,107,C,282,25,ATL,44,193
35,55,,6,88,.516,83,53,.546,97,30,.323,93,.437,190,84,.857,98,49,0,630,Danilo Gallinari,20,50,SF,280,14,3TM,23,108
25,64,,24,80,.488,86,57,.509,112,29,.309,94,.417,206,76,.745,102,60,11,960,Josh Okogie,74,68,SG,277,48,PHO,36,154
21,110,,27,198,.533,95,42,.500,84,53,.368,144,.417,228,33,.805,41,69,1,897,Jaylin Williams,36,98,C,276,28,OKC,34,234
28,65,,33,84,.539,106,96,.578,166,10,.250,40,.515,206,52,.800,65,56,3,763,Jock Landale,88,74,C,274,20,HOU,31,172
20,166,,9,76,.502,102,90,.563,160,12,.218,55,.474,215,52,.667,78,61,3,876,Blake Wesley,18,89,SG,268,29,SAS,55,94
28,64,,15,136,.522,108,85,.559,152,23,.299,77,.472,229,26,.667,39,65,9,1031,Jae'Sean Tate,61,137,SF,265,42,HOU,37,197
24,48,,14,72,.468,91,54,.435,124,37,.336,110,.389,234,41,.759,54,48,26,984,Cam Reddish,27,64,SF,260,47,LAL,31,99
25,41,,60,161,.553,97,72,.537,134,25,.391,64,.490,198,34,.680,50,57,17,740,Mo Bamba,77,101,C,253,22,PHI,39,238
21,29,,4,56,.563,80,8,.615,13,72,.373,193,.388,206,21,.808,26,59,13,815,Caleb Houstan,28,61,SF,253,15,ORL,16,84
24,30,,4,55,.599,83,14,.519,27,69,.408,169,.423,196,17,.895,19,56,0,614,A.J. Green,9,49,SG,252,9,MIL,12,64
22,53,,2,74,.500,90,41,.562,73,49,.314,156,.393,229,23,.885,26,57,1,814,Ben Sheppard,15,88,SG,252,33,IND,15,89
24,60,,3,119,.476,84,37,.435,85,47,.333,141,.372,226,32,.865,37,59,15,827,Troy Brown Jr.,25,42,SF,247,24,2TM,30,144
33,55,,17,174,.569,87,87,.592,147,0,.000,6,.569,153,70,.707,99,46,11,674,Mason Plumlee,60,68,C,244,14,LAC,36,234
31,48,,18,67,.617,103,83,.648,128,20,.364,55,.563,183,14,.609,23,44,0,680,Gary Payton II,46,77,SG,240,39,GSW,27,113
27,110,,51,185,.514,88,50,.568,88,38,.317,120,.423,208,21,.840,25,55,23,1173,John Konchar,72,76,SF,235,51,MEM,46,257
34,67,,9,62,.595,88,33,.569,58,55,.404,136,.454,194,3,.750,4,58,9,862,Justin Holiday,9,69,SG,234,36,DEN,14,71
26,44,,8,80,.486,80,36,.434,83,44,.346,127,.381,210,26,.788,33,59,11,719,Chris Duarte,26,80,SF,230,28,SAC,26,106
21,47,,7,56,.462,82,41,.488,84,41,.297,138,.369,222,22,.710,31,50,0,545,Julian Strawther,5,54,SF,227,17,DEN,23,61
33,44,,6,50,.485,80,42,.438,96,38,.352,108,.392,204,28,.903,31,44,4,616,Seth Curry,18,39,SG,226,22,2TM,21,68
28,19,,7,66,.558,84,39,.549,71,45,.375,120,.440,191,12,.800,15,42,0,511,Sasha Vezenkov,30,42,PF,225,20,SAC,12,96
23,51,,12,90,.558,97,89,.582,153,8,.286,28,.536,181,22,.537,41,60,2,746,KJ Martin,41,100,SF,224,22,2TM,32,131
24,17,,25,105,.689,93,71,.717,99,22,.423,52,.616,151,15,.789,19,43,0,469,Bol Bol,32,42,PF,223,10,PHO,19,137
25,29,,18,136,.552,99,94,.588,160,5,.208,24,.538,184,19,.679,28,48,12,545,Omer Yurtseven,72,52,C,222,8,UTA,37,208
27,60,,6,61,.451,79,61,.466,131,18,.281,64,.405,195,40,.816,49,48,0,581,Shake Milton,14,54,SG,216,19,3TM,31,75
23,45,,4,84,.492,76,52,.495,105,24,.324,74,.425,179,38,.826,46,43,3,664,Jalen Wilson,47,48,PF,214,11,BRK,19,131
23,31,,7,77,.578,81,51,.560,91,30,.400,75,.488,166,19,.679,28,48,1,608,MarJon Beauchamp,22,54,SF,211,13,MIL,27,99
31,119,,11,67,.460,74,49,.408,120,25,.368,68,.394,188,37,.822,45,47,1,742,Delon Wright,19,32,PG,210,54,2TM,14,86
32,84,,20,117,.684,72,71,.689,103,1,.333,3,.679,106,63,.708,89,63,9,836,Dwight Powell,97,113,C,208,26,DAL,32,214
26,35,,5,50,.524,81,68,.562,121,13,.283,46,.485,167,32,.653,49,43,0,393,Eugene Omoruyi,35,62,SF,207,27,WAS,21,85
25,44,,8,99,.493,68,53,.541,98,15,.273,55,.444,153,50,.602,83,55,1,630,Oshae Brissett,61,54,SF,201,19,BOS,20,160
21,29,,27,103,.514,80,52,.510,102,28,.346,81,.437,183,11,.550,20,63,3,781,JT Thor,43,60,PF,199,11,CHO,15,146
28,38,,22,79,.497,72,51,.526,97,21,.304,69,.434,166,32,.762,42,53,8,665,Keita Bates-Diop,31,35,SF,197,25,2TM,15,110
27,110,,7,54,.628,70,28,.500,56,42,.472,89,.483,145,13,.722,18,56,0,626,Jordan McLaughlin,18,31,PG,195,35,MIN,19,72
32,68,,30,113,.541,63,31,.574,54,32,.348,92,.432,146,33,.702,47,43,7,871,Maxi Kleber,30,79,C,191,17,DAL,28,143
24,49,,12,102,.532,73,54,.593,91,19,.297,64,.471,155,25,.735,34,46,5,451,Sandro Mamukelashvili,45,35,C,190,7,SAS,19,147
31,34,,11,57,.500,75,65,.546,119,10,.244,41,.469,160,29,.806,36,50,3,466,Anthony Gill,37,48,PF,189,13,WAS,23,94
23,32,,38,65,.483,69,63,.500,126,6,.261,23,.463,149,42,.677,62,58,0,576,Zeke Nnaji,61,81,PF,186,15,DEN,27,126
36,17,,20,84,.602,79,78,.624,125,1,.143,7,.598,132,26,.578,45,46,0,339,JaVale McGee,42,46,C,185,14,SAC,34,126
21,81,,18,84,.494,69,52,.627,83,17,.230,74,.439,157,25,.581,43,59,2,681,Dalen Terry,29,81,SG,180,27,CHI,32,113
24,19,,7,80,.421,60,47,.500,94,13,.203,64,.380,158,44,.786,56,43,7,404,Luka Å amaniÄ,22,32,PF,177,5,UTA,28,102
25,137,,5,37,.570,60,9,.375,24,51,.405,126,.400,150,2,1.000,2,41,14,699,Jacob Gilyard,9,39,PG,173,33,2TM,30,46
26,37,,6,61,.376,65,53,.449,118,12,.169,71,.344,189,27,.730,37,50,1,538,Jalen McDaniels,18,52,SF,169,19,TOR,30,79
21,44,,15,45,.432,59,49,.490,100,10,.208,48,.399,148,35,.833,42,49,2,507,Jaden Springer,33,66,PG,163,36,2TM,34,78
26,35,,1,40,.569,57,15,.517,29,42,.389,108,.416,137,6,.667,9,41,2,413,Svi Mykhailiuk,11,19,SF,162,11,BOS,12,51
32,51,,14,101,.608,73,73,.613,119,0,.000,1,.608,120,15,.288,52,49,0,549,Tristan Thompson,73,59,C,161,12,CLE,29,174
32,36,,13,86,.449,56,28,.467,60,28,.292,96,.359,156,17,.680,25,53,6,600,Mike Muscala,39,52,C,157,9,3TM,22,125
21,32,,10,54,.448,62,48,.421,114,14,.350,40,.403,154,14,.583,24,50,6,613,Johnny Davis,18,57,SG,152,18,WAS,13,72
23,21,,10,61,.544,57,36,.667,54,21,.300,70,.460,124,17,.850,20,45,2,458,Nassir Little,14,39,SF,152,10,PHO,14,75
35,145,,4,65,.430,66,62,.413,150,4,.500,8,.418,158,3,.750,4,43,5,741,Ish Smith,11,49,PG,139,17,CHO,47,76
23,20,,3,36,.500,54,41,.577,71,13,.260,50,.446,121,15,.652,23,42,0,311,A.J. Lawson,14,22,SG,136,10,DAL,14,50
22,50,,6,70,.585,50,33,.611,54,17,.370,46,.500,100,8,.727,11,57,8,572,Andre Jackson Jr.,43,92,SG,125,16,MIL,28,113
30,50,,33,82,.617,50,50,.641,78,0,.000,3,.617,81,20,.588,34,48,0,444,Alex Len,46,66,C,120,11,SAC,27,128
25,20,,7,62,.460,40,17,.567,30,23,.280,82,.357,112,4,.571,7,47,8,432,Chuma Okeke,18,19,SF,107,9,ORL,16,80
32,15,,5,67,.579,34,7,.467,15,27,.403,67,.415,82,1,1.000,1,44,0,417,Reggie Bullock,6,29,SF,96,12,HOU,10,73
23,15,,4,33,.537,34,14,.467,30,20,.385,52,.415,82,5,.556,9,54,0,275,Kessler Edwards,9,26,SF,93,10,SAC,4,42
25,25,,19,91,.691,38,38,.691,55,0,,0,.691,55,16,.667,24,45,11,585,Jericho Sims,56,45,C,92,8,NYK,16,147
24,25,,6,42,.489,37,23,.548,42,14,.292,48,.411,90,1,.500,2,44,0,394,Kobe Brown,20,49,PF,89,12,LAC,9,62
31,39,,5,64,.427,26,25,.424,59,1,.333,3,.419,62,23,.605,38,43,0,320,Cody Zeller,48,45,C,76,9,NOP,16,112
24,342,"MVP-4,CPOY-10,AS,NBA1",51,571,.543,727,487,.558,873,240,.350,686,.466,1559,531,.854,622,74,74,2732,Jayson Tatum,78,160,SF,2225,78,BOS,213,649
28,274,"MVP-1,DPOY-9,CPOY-5,AS,NBA1",112,557,.573,728,662,.587,1128,66,.330,200,.548,1328,661,.857,771,66,66,2284,Joel Embiid,113,205,C,2183,66,PHI,226,670
23,529,"MVP-8,CPOY-8,AS,NBA1",33,515,.560,719,534,.588,908,185,.342,541,.496,1449,515,.742,694,66,66,2391,Luka DonÄiÄ,54,166,PG,2138,90,DAL,236,569
24,371,"MVP-5,CPOY-7,AS,NBA1",65,270,.531,704,646,.533,1213,58,.345,168,.510,1381,669,.905,739,68,68,2416,Shai Gilgeous-Alexander,59,192,PG,2135,112,OKC,192,329
28,359,"MVP-3,DPOY-6,AS,NBA1",51,605,.572,707,660,.596,1107,47,.275,171,.553,1278,498,.645,772,63,63,2024,Giannis Antetokounmpo,137,197,PF,1959,52,MIL,246,742
21,350,AS,58,411,.528,707,494,.513,963,213,.369,578,.459,1541,319,.756,422,79,79,2842,Anthony Edwards,47,186,SG,1946,125,MIN,259,458
28,316,"CPOY-14,AS,NBA3",21,626,.536,658,440,.553,796,218,.343,636,.459,1432,402,.757,531,77,77,2737,Julius Randle,141,233,PF,1936,49,NYK,216,767
26,301,"MVP-6,CPOY-6,AS,NBA2",27,226,.572,679,434,.566,767,245,.386,635,.484,1402,319,.867,368,68,68,2432,Donovan Mitchell,63,168,SG,1922,99,CLE,180,289
24,741,,9,161,.485,597,443,.476,930,154,.335,460,.429,1390,566,.886,639,73,73,2541,Trae Young,56,104,PG,1914,80,ATL,300,217
27,327,,18,303,.558,673,469,.556,844,204,.375,544,.485,1388,363,.848,428,77,77,2768,Zach LaVine,42,159,SG,1913,69,CHI,194,345
32,425,"CPOY-10,AS,NBA3",18,233,.564,556,312,.574,544,244,.371,658,.463,1202,510,.914,558,58,58,2107,Damian Lillard,44,109,PG,1866,50,POR,191,277
25,447,"MVP-11,CPOY-1,AS,NBA3",23,266,.557,682,563,.584,964,119,.324,367,.512,1331,343,.780,440,73,73,2435,De'Aaron Fox,40,172,PG,1826,83,SAC,181,306
33,377,"CPOY-3,AS",36,309,.522,657,611,.526,1161,46,.324,142,.504,1303,456,.872,523,74,74,2682,DeMar DeRozan,34,186,SF,1816,83,CHI,153,343
26,232,"AS,NBA2",26,381,.550,679,516,.576,896,163,.335,487,.491,1383,263,.765,344,67,67,2405,Jaylen Brown,78,172,SF,1784,75,BOS,197,459
28,415,AS,36,425,.515,630,537,.523,1026,93,.324,287,.480,1313,367,.774,474,71,71,2652,Pascal Siakam,131,228,PF,1720,65,TOR,169,556
25,123,"MIP-1,AS",38,440,.586,571,371,.585,634,200,.391,511,.499,1145,349,.875,399,66,66,2273,Lauri Markkanen,130,137,PF,1691,42,UTA,127,570
27,678,"MVP-2,CPOY-13,AS,NBA2",47,650,.660,646,589,.675,873,57,.383,149,.632,1022,341,.822,415,69,69,2323,Nikola JokiÄ,167,174,C,1690,87,DEN,247,817
20,281,,18,241,.485,566,379,.471,805,187,.338,554,.416,1359,364,.786,463,76,76,2602,Jalen Green,43,131,SG,1683,59,HOU,200,284
23,369,,21,193,.514,550,336,.524,641,214,.336,637,.430,1278,361,.870,415,82,43,2458,Jordan Poole,32,214,PG,1675,63,GSW,252,225
26,273,,61,285,.535,593,424,.514,825,169,.382,442,.468,1267,316,.895,353,83,83,2963,Mikal Bridges,79,159,SG,1671,91,2TM,127,364
34,352,"MVP-9,CPOY-9,AS,NBA2",20,302,.614,559,286,.579,494,273,.427,639,.493,1133,257,.915,281,56,56,1941,Stephen Curry,39,117,PG,1648,52,GSW,179,341
26,421,"MVP-12,CPOY-4",15,201,.547,587,453,.519,873,134,.416,322,.491,1195,325,.829,392,68,68,2379,Jalen Brunson,40,152,PG,1633,61,NYK,142,241
30,331,"CPOY-12,AS",45,245,.572,594,406,.574,707,188,.379,496,.494,1203,247,.905,273,60,60,2241,Kyrie Irving,59,165,SG,1623,66,2TM,128,304
23,493,"MVP-12,AS",16,296,.504,566,474,.519,914,92,.307,300,.466,1214,372,.748,497,61,59,1948,Ja Morant,61,100,PG,1596,66,MEM,206,357
38,375,"AS,NBA3",32,392,.549,609,488,.580,842,121,.321,377,.500,1219,251,.768,327,55,54,1954,LeBron James,65,88,PF,1590,50,LAL,178,457
31,429,,38,273,.515,587,376,.469,801,211,.389,543,.437,1344,183,.769,238,75,75,2649,CJ McCollum,55,153,PG,1568,70,NOP,183,328
25,240,"DPOY-5,AS",61,504,.541,602,601,.545,1102,1,.083,12,.540,1114,324,.806,402,75,75,2598,Bam Adebayo,184,208,C,1529,88,MIA,187,688
26,448,,19,336,.514,612,479,.514,932,133,.344,387,.464,1319,158,.832,190,74,74,2693,Dejounte Murray,53,106,SG,1515,112,ATL,160,389
26,573,"MVP-7,AS,NBA3",39,722,.632,577,546,.639,855,31,.373,83,.615,938,325,.742,438,79,79,2736,Domantas Sabonis,251,279,C,1510,65,SAC,230,973
32,163,,29,247,.556,546,245,.470,521,301,.412,731,.436,1252,116,.879,132,69,69,2279,Klay Thompson,39,130,SF,1509,49,GSW,123,286
27,174,,100,432,.565,507,370,.559,662,137,.385,356,.498,1018,354,.851,416,65,65,2120,Kristaps PorziÅÄ£is,114,196,C,1505,58,WAS,137,546
23,538,,9,157,.537,522,353,.492,717,169,.410,412,.462,1129,277,.863,321,69,69,2447,Darius Garland,28,148,PG,1490,85,CLE,199,185
21,283,,17,259,.543,542,412,.544,758,130,.361,360,.485,1118,271,.842,322,80,80,2609,Franz Wagner,70,183,SF,1485,77,ORL,167,329
26,293,,18,194,.546,527,416,.554,751,111,.351,316,.494,1067,306,.855,358,53,53,1835,Devin Booker,46,159,SG,1471,51,PHO,145,240
33,340,"MVP-10,DPOY-12,CPOY-2,NBA2",21,234,.560,479,443,.564,785,36,.350,103,.539,888,472,.850,555,64,64,2138,Jimmy Butler,141,80,PF,1466,117,MIA,101,375
29,148,,114,507,.573,542,523,.589,888,19,.257,74,.563,962,348,.784,444,56,54,1904,Anthony Davis,195,146,C,1451,59,LAL,122,702
32,265,,57,744,.573,597,476,.594,801,121,.349,347,.520,1148,132,.835,158,82,82,2746,Nikola VuÄeviÄ,159,179,C,1447,60,CHI,139,903
20,269,ROY-1,39,413,.465,479,394,.471,837,85,.298,285,.427,1122,394,.738,534,72,72,2430,Paolo Banchero,84,160,PF,1437,60,ORL,200,497
22,201,,15,308,.485,510,389,.495,786,121,.310,390,.434,1176,290,.740,392,73,73,2475,RJ Barrett,60,179,SG,1431,31,NYK,164,368
23,183,,11,262,.512,503,369,.523,706,134,.329,407,.452,1113,245,.749,327,63,63,2063,Keldon Johnson,56,125,SF,1385,46,SAS,134,318
29,515,,24,242,.524,460,279,.498,560,181,.369,490,.438,1050,268,.812,330,79,79,2725,Spencer Dinwiddie,28,187,SG,1369,67,2TM,145,270
34,235,AS,67,296,.614,483,390,.617,632,93,.404,230,.560,862,307,.919,334,47,47,1672,Kevin Durant,17,99,PF,1366,34,2TM,156,313
27,239,,29,408,.518,512,352,.533,661,160,.333,481,.448,1142,173,.730,237,64,64,2239,Kyle Kuzma,55,145,PF,1357,36,WAS,190,463
23,280,,16,333,.531,487,284,.497,572,203,.378,537,.439,1109,170,.934,182,67,67,2337,Tyler Herro,27,101,SG,1347,51,MIA,158,360
30,225,,26,333,.596,475,187,.518,361,288,.425,677,.458,1038,106,.822,129,80,73,2482,Buddy Hield,67,156,SF,1344,92,IND,139,400
28,495,,38,250,.486,437,230,.455,506,207,.342,606,.393,1112,254,.898,283,69,69,2535,Fred VanVleet,30,193,PG,1335,123,TOR,140,280
32,288,AS,20,297,.536,459,301,.521,578,158,.371,426,.457,1004,256,.871,294,56,56,1939,Paul George,45,159,SF,1332,83,LAC,176,342
28,319,,16,208,.484,493,328,.480,683,165,.327,505,.415,1188,178,.809,220,63,63,2221,Terry Rozier,51,119,SG,1329,74,CHO,134,259
23,253,,14,143,.548,467,255,.528,483,212,.377,562,.447,1045,160,.894,179,62,62,2171,Anfernee Simons,18,142,SG,1306,42,POR,128,161
20,116,"ROY-4,6MOY-8",13,231,.487,413,313,.488,641,100,.323,310,.434,951,376,.828,454,78,17,2222,Bennedict Mathurin,87,162,SG,1302,48,IND,152,318
25,400,,16,209,.537,473,301,.494,609,172,.398,432,.454,1041,180,.833,216,65,65,2133,Jamal Murray,48,103,PG,1298,66,DEN,145,257
28,150,,53,230,.554,434,290,.523,554,144,.401,359,.475,913,278,.813,342,63,63,2246,Jerami Grant,53,152,PF,1290,51,POR,116,283
32,495,"DPOY-7,AS",25,262,.556,490,332,.542,612,158,.384,411,.479,1023,152,.859,177,67,65,2183,Jrue Holiday,79,116,PG,1290,79,MIL,197,341
21,224,DPOY-3,119,524,.566,525,503,.595,845,22,.216,102,.554,947,205,.674,304,79,79,2715,Evan Mobley,187,218,PF,1277,60,CLE,146,711
33,152,,8,187,.570,430,285,.539,529,145,.411,353,.488,882,268,.884,303,59,59,1893,Bojan BogdanoviÄ,36,113,PF,1273,34,DET,135,223
30,270,,13,174,.519,458,303,.530,572,155,.338,459,.444,1031,200,.816,245,61,61,1988,Jordan Clarkson,72,120,SG,1271,33,UTA,186,246
26,437,,29,180,.572,445,251,.548,458,194,.396,490,.469,948,179,.829,216,71,71,2304,D'Angelo Russell,35,140,PG,1263,70,2TM,186,215
20,469,,31,451,.516,539,463,.524,884,76,.325,234,.482,1118,106,.731,145,76,76,2367,Josh Giddey,148,143,PF,1260,57,OKC,211,599
24,254,,22,248,.568,450,284,.534,532,166,.408,407,.479,939,181,.883,205,58,58,1841,Desmond Bane,43,150,SG,1247,56,MEM,126,291
31,204,,28,281,.572,446,342,.551,621,104,.416,250,.512,871,243,.871,279,52,50,1748,Kawhi Leonard,57,84,SF,1239,72,LAC,88,338
34,99,DPOY-2,193,363,.606,477,341,.637,535,136,.374,364,.531,899,149,.784,190,78,78,2373,Brook Lopez,157,203,C,1239,37,MIL,107,520
30,128,,10,279,.556,374,242,.553,438,132,.374,353,.473,791,350,.847,413,82,82,2662,Harrison Barnes,87,103,PF,1230,57,SAC,86,366
22,212,,8,153,.568,439,279,.513,544,160,.434,369,.481,913,180,.845,213,60,41,2016,Tyrese Maxey,23,132,SG,1218,49,PHI,80,176
33,618,,31,314,.536,371,210,.495,424,161,.385,418,.441,842,313,.867,361,58,58,2135,James Harden,40,112,PG,1216,71,PHI,195,354
23,279,6MOY-2,14,279,.537,419,251,.521,482,168,.370,454,.448,936,203,.819,248,81,21,2344,Immanuel Quickley,58,166,SG,1209,80,NYK,100,337
20,387,ROY-6,17,215,.477,409,289,.457,633,120,.343,350,.416,983,266,.747,356,74,73,2304,Jaden Ivey,73,242,SG,1204,61,DET,237,288
24,115,,53,495,.592,522,515,.597,863,7,.292,24,.589,887,152,.760,200,67,67,2035,Deandre Ayton,172,190,C,1203,37,PHO,120,667
21,371,,61,333,.487,463,400,.505,792,63,.281,224,.456,1016,190,.772,246,77,76,2678,Scottie Barnes,179,170,SF,1179,83,TOR,154,512
23,60,"DPOY-1,AS",189,318,.567,416,316,.585,540,100,.355,282,.506,822,241,.788,306,63,63,1787,Jaren Jackson Jr.,108,227,C,1173,65,MEM,107,426
29,271,,33,155,.551,444,364,.552,659,80,.365,219,.506,878,192,.842,228,50,50,1673,Bradley Beal,41,107,SG,1160,45,WAS,145,196
22,585,AS,25,172,.586,412,251,.572,439,161,.400,402,.490,841,175,.871,201,56,56,1883,Tyrese Haliburton,33,69,PG,1160,91,IND,141,205
34,551,6MOY-9,33,334,.481,432,343,.487,705,89,.311,286,.436,991,206,.656,314,73,24,2126,Russell Westbrook,89,162,PG,1159,76,2TM,255,423
22,112,,43,222,.610,387,185,.611,303,202,.406,497,.484,800,172,.905,190,79,65,2448,Trey Murphy III,59,155,SF,1148,89,NOP,61,281
24,106,,14,143,.522,405,239,.493,485,166,.369,450,.433,935,172,.839,205,66,44,2118,Gary Trent Jr.,30,102,SG,1148,104,TOR,55,173
24,175,,79,285,.520,434,285,.518,550,149,.348,428,.444,978,127,.730,174,73,73,2380,P.J. Washington,73,193,PF,1144,66,CHO,110,358
24,221,,24,209,.603,420,215,.604,356,205,.402,510,.485,866,95,.725,131,75,75,2203,Kevin Huerter,42,181,SG,1140,80,SAC,97,251
22,338,,17,238,.522,391,250,.501,499,141,.366,385,.442,884,207,.784,264,59,59,2024,Kevin Porter Jr.,76,156,PG,1130,82,HOU,188,314
25,131,DPOY-7,50,237,.556,421,279,.539,518,142,.387,367,.476,885,140,.838,167,67,67,2386,OG Anunoby,95,200,SF,1124,128,TOR,132,332
30,140,,52,579,.570,446,408,.577,707,38,.349,109,.547,816,185,.826,224,79,79,1968,Jonas ValanÄiÅ«nas,225,245,C,1115,20,NOP,159,804
27,121,6MOY-9,72,404,.583,396,291,.594,490,105,.376,279,.515,769,217,.772,281,67,17,1738,Christian Wood,87,169,C,1114,30,DAL,121,491
26,89,,140,378,.612,402,309,.638,484,93,.373,249,.548,733,216,.783,276,62,62,1825,Myles Turner,88,215,C,1113,36,IND,103,466
25,262,,19,223,.522,404,340,.507,671,64,.390,164,.484,835,240,.882,272,45,45,1538,Brandon Ingram,23,116,SF,1112,32,NOP,148,246
27,203,,51,282,.603,429,369,.628,588,60,.347,173,.564,761,191,.608,314,68,68,2055,Aaron Gordon,164,129,PF,1109,54,DEN,98,446
20,291,,70,436,.565,442,423,.570,742,19,.333,57,.553,799,206,.715,288,75,72,2171,Alperen Sengun,242,258,C,1109,70,HOU,193,678
30,186,,40,357,.575,423,297,.570,521,126,.389,324,.501,845,113,.876,129,74,74,2436,Tobias Harris,67,149,SF,1085,68,PHI,89,424
24,65,,29,277,.602,398,210,.579,363,188,.414,454,.487,817,96,.800,120,62,62,1798,Michael Porter Jr.,64,119,SF,1080,37,DEN,68,341
23,118,,13,264,.513,353,202,.483,418,151,.361,418,.422,836,205,.861,238,77,37,2129,Saddiq Bey,98,123,SF,1062,70,2TM,71,362
21,248,ROY-2,35,253,.567,414,341,.579,589,73,.356,205,.521,794,155,.812,191,75,62,2276,Jalen Williams,84,191,SG,1056,103,OKC,123,337
27,189,,16,199,.468,392,249,.451,552,143,.326,439,.396,991,120,.779,154,73,73,2214,Dillon Brooks,45,240,SF,1047,65,MEM,104,244
24,298,6MOY-5,20,171,.538,357,214,.538,398,143,.359,398,.448,796,184,.889,207,77,0,1719,Malik Monk,32,125,SG,1041,49,SAC,146,203
22,123,,30,326,.617,410,342,.679,504,68,.315,216,.569,720,151,.680,222,82,49,2292,KJ Martin,126,147,SF,1039,41,HOU,91,452
25,94,,17,238,.522,379,279,.521,536,100,.350,286,.461,822,171,.826,207,67,67,2126,De'Andre Hunter,46,199,SF,1029,35,ATL,82,284
26,124,,9,248,.520,370,135,.484,279,235,.357,658,.395,937,50,.769,65,81,27,2093,Malik Beasley,35,107,SG,1025,65,2TM,90,283
30,129,,12,230,.527,340,128,.431,297,212,.385,550,.401,847,127,.770,165,71,45,2152,Tim Hardaway Jr.,21,120,SF,1019,49,DAL,60,251
29,109,6MOY-4,18,151,.559,340,226,.534,423,114,.397,287,.479,710,225,.812,277,60,8,1567,Norman Powell,24,125,SG,1019,50,LAC,101,175
28,321,,76,241,.560,350,201,.548,367,149,.381,391,.462,758,168,.875,192,82,70,2319,Derrick White,52,177,SG,1017,54,BOS,95,293
23,154,,23,216,.466,339,204,.440,464,135,.330,409,.388,873,200,.772,259,74,73,2272,Luguentz Dort,128,243,SF,1013,75,OKC,92,344
19,101,,74,447,.475,364,244,.487,501,120,.307,391,.408,892,162,.786,206,79,79,2451,Jabari Smith Jr.,122,227,PF,1010,43,HOU,104,569
30,248,6MOY-1,18,238,.574,354,222,.510,435,132,.444,297,.484,732,160,.870,184,67,0,1744,Malcolm Brogdon,42,109,PG,1000,45,BOS,98,280
27,105,6MOY-3,16,518,.555,398,303,.555,546,95,.370,257,.496,803,96,.768,125,70,22,1818,Bobby Portis,154,115,PF,987,29,MIL,81,672
22,98,ROY-5,42,282,.584,354,148,.527,281,206,.411,501,.453,782,62,.765,81,80,78,2382,Keegan Murray,89,162,SF,976,61,SAC,60,371
27,54,,18,184,.497,353,245,.510,480,108,.319,339,.431,819,158,.760,208,48,40,1548,Kelly Oubre Jr.,65,141,SF,972,68,CHO,64,249
24,113,,84,445,.645,403,402,.653,616,1,.100,10,.644,626,162,.733,221,68,68,2220,Jarrett Allen,221,153,C,969,54,CLE,93,666
23,144,DPOY-9,189,518,.705,414,414,.708,585,0,.000,2,.705,587,133,.541,246,76,76,2271,Nic Claxton,184,212,C,961,65,BRK,96,702
22,148,,76,215,.591,370,263,.588,447,107,.398,269,.517,716,106,.736,144,79,79,2416,Jaden McDaniels,92,272,SF,953,74,MIN,112,307
30,87,,95,583,.659,360,360,.663,543,0,.000,3,.659,546,219,.644,340,70,70,2148,Rudy Gobert,231,210,C,939,56,MIN,122,814
25,85,,73,385,.557,359,289,.619,467,70,.292,240,.508,707,143,.803,178,71,71,2130,John Collins,77,220,PF,931,42,ATL,79,462
26,268,,51,265,.545,358,267,.548,487,91,.358,254,.483,741,116,.758,153,80,31,2280,Bruce Brown,63,190,SF,923,87,DEN,123,328
26,171,,12,209,.535,324,127,.559,227,197,.350,563,.410,790,78,.876,89,80,33,2272,Max Strus,49,166,SF,923,42,MIA,70,258
28,287,,24,229,.517,320,193,.462,418,127,.392,324,.431,742,130,.722,180,74,30,2237,Caris LeVert,53,170,SG,897,72,CLE,116,282
27,197,,86,417,.629,389,389,.630,617,0,.000,1,.629,618,119,.592,201,72,71,1906,Jakob Poeltl,236,195,C,897,66,2TM,125,653
23,448,,9,189,.489,341,296,.506,585,45,.285,158,.459,743,148,.860,172,68,65,1984,Tre Jones,56,98,PG,875,89,SAS,110,245
23,132,,33,377,.591,322,242,.624,388,80,.356,225,.525,613,144,.738,195,57,54,1690,Wendell Carter Jr.,120,159,C,868,30,ORL,106,497
32,245,,47,471,.680,329,329,.680,484,0,,0,.680,484,199,.636,313,79,60,2054,Mason Plumlee,229,217,C,857,46,2TM,117,700
34,183,,25,118,.547,291,159,.535,297,132,.371,356,.446,653,142,.821,173,69,58,1965,Eric Gordon,16,78,SG,856,43,2TM,104,134
31,252,,37,338,.583,278,185,.576,321,93,.394,236,.499,557,198,.853,232,68,68,1942,Kelly Olynyk,82,232,C,847,60,UTA,168,420
24,341,,26,165,.534,349,322,.544,592,27,.310,87,.514,679,112,.783,143,60,60,1778,Markelle Fultz,69,131,PG,837,87,ORL,139,234
24,215,6MOY-7,19,160,.616,259,173,.631,274,86,.398,216,.529,490,229,.864,265,64,22,1843,Austin Reaves,33,108,SG,833,33,LAL,99,193
21,100,,70,249,.549,314,199,.498,400,115,.415,277,.464,677,90,.857,105,82,65,2323,Patrick Williams,78,147,PF,833,72,CHI,101,327
29,298,,10,144,.472,270,196,.461,425,74,.329,225,.415,650,216,.857,252,66,50,1986,Dennis SchrÃ¶der,21,145,PG,830,50,LAL,112,165
26,417,6MOY-6,6,172,.523,311,190,.495,384,121,.371,326,.438,710,80,.800,100,80,22,1940,Tyus Jones,28,32,PG,823,83,MEM,74,200
29,183,,35,173,.569,292,157,.502,313,135,.423,319,.462,632,103,.824,125,76,76,2381,Kentavious Caldwell-Pope,35,145,SG,822,112,DEN,86,208
23,87,,9,174,.637,291,128,.637,201,163,.424,384,.497,585,75,.852,88,74,45,2093,Corey Kispert,33,97,SF,820,32,WAS,55,207
37,524,,22,224,.513,294,196,.482,407,98,.375,261,.440,668,133,.831,160,59,59,1889,Chris Paul,27,126,PG,819,91,PHO,114,251
25,77,,98,520,.634,326,326,.637,512,0,.000,2,.634,514,166,.697,238,76,76,2170,Ivica Zubac,236,219,C,818,29,LAC,117,756
22,150,,26,180,.599,282,125,.641,195,157,.386,407,.468,602,78,.796,98,71,66,2121,Quentin Grimes,49,177,SG,799,47,NYK,69,229
35,450,,14,149,.539,261,126,.486,259,135,.385,351,.428,610,141,.834,169,67,66,2029,Mike Conley,33,139,PG,798,73,2TM,103,182
22,81,,107,359,.642,317,313,.647,484,4,.308,13,.638,497,153,.781,196,80,18,1849,Onyeka Okongwu,217,251,C,791,56,ATL,81,576
19,94,,24,173,.551,306,204,.559,365,102,.360,283,.472,648,75,.714,105,80,15,1779,Shaedon Sharpe,63,136,SG,789,38,POR,83,236
21,470,,28,193,.426,307,227,.429,529,80,.280,286,.377,815,92,.821,112,76,56,2154,Killian Hayes,28,219,PG,786,104,DET,173,221
22,235,,31,241,.516,277,202,.500,404,75,.364,206,.454,610,152,.894,170,60,4,1552,Cole Anthony,47,158,PG,781,37,ORL,91,288
23,77,,53,260,.602,310,235,.653,360,75,.346,217,.537,577,86,.677,127,68,11,1251,Naz Reid,73,176,C,781,42,MIN,92,333
24,197,,41,243,.546,277,120,.484,248,157,.390,403,.425,651,69,.793,87,77,58,2150,De'Anthony Melton,69,191,SG,780,126,PHI,102,312
28,58,,79,459,.653,350,350,.654,535,0,.000,1,.653,536,79,.603,131,65,63,1730,Clint Capela,258,139,C,779,45,ATL,54,717
21,88,,47,301,.493,296,237,.486,488,59,.343,172,.448,660,109,.752,145,82,5,1767,Tari Eason,195,189,PF,760,96,HOU,101,496
30,150,,18,142,.566,273,127,.506,251,146,.406,360,.447,611,64,.831,77,54,9,1508,Bogdan BogdanoviÄ,23,86,SG,756,43,ATL,65,165
25,130,,34,283,.518,281,204,.530,385,77,.332,232,.455,617,116,.841,138,80,24,1913,Jalen McDaniels,63,209,SF,755,83,2TM,93,346
27,163,,14,176,.571,245,99,.518,191,146,.399,366,.440,557,114,.905,126,72,70,1972,Grayson Allen,61,117,SG,750,62,MIL,72,237
27,290,,21,451,.588,275,214,.601,356,61,.372,164,.529,520,132,.750,176,76,52,2454,Josh Hart,142,195,SF,743,88,2TM,117,593
23,98,,34,215,.525,252,137,.496,276,115,.366,314,.427,590,119,.838,142,73,60,1816,Aaron Nesmith,62,235,SF,738,55,IND,75,277
32,206,,12,182,.520,276,224,.532,421,52,.325,160,.475,581,129,.811,159,50,50,1577,Gordon Hayward,33,70,SF,733,42,CHO,99,215
25,180,,49,286,.568,284,229,.571,401,55,.374,147,.518,548,108,.761,142,63,26,1441,Zach Collins,116,199,C,731,37,SAS,129,402
33,114,,21,229,.513,274,162,.484,335,112,.364,308,.426,643,68,.782,87,65,65,1825,Marcus Morris,29,136,PF,728,42,LAC,56,258
22,204,,6,196,.551,263,135,.540,250,128,.372,344,.443,594,61,.871,70,74,2,1730,Coby White,16,122,SG,715,54,CHI,74,212
26,184,,22,199,.593,272,195,.598,326,77,.389,198,.519,524,92,.780,118,81,36,1872,Terance Mann,77,149,SG,713,42,LAC,80,276
30,29,,64,264,.552,261,199,.585,340,62,.328,189,.493,529,128,.762,168,76,0,1523,Chris Boucher,157,143,PF,712,47,TOR,41,421
23,341,,13,164,.512,284,192,.504,381,92,.350,263,.441,644,49,.790,62,75,63,2073,Andrew Nembhard,35,179,SG,709,70,IND,126,199
24,58,,26,230,.530,284,233,.550,424,51,.319,160,.486,584,88,.739,119,63,9,1466,Rui Hachimura,53,72,PF,707,19,2TM,53,283
24,84,,99,270,.732,289,289,.732,395,0,,0,.732,395,127,.679,187,78,47,1604,Daniel Gafford,163,187,C,705,33,WAS,85,433
23,132,,5,134,.502,280,213,.542,393,67,.289,232,.448,625,77,.778,99,65,2,1252,Jaylen Nowell,36,101,SG,704,42,MIN,65,170
28,382,,23,145,.511,250,135,.519,260,115,.336,342,.415,602,88,.746,118,61,61,1957,Marcus Smart,46,172,PG,703,93,BOS,143,191
22,246,,29,169,.467,257,199,.485,410,58,.286,203,.419,613,126,.750,168,65,20,1313,Talen Horton-Tucker,41,108,SG,698,41,UTA,126,210
25,189,,14,231,.490,247,181,.513,353,66,.303,218,.433,571,138,.789,175,77,21,1792,Naji Marshall,48,113,SF,698,54,NOP,97,279
22,211,,29,413,.497,253,184,.530,347,69,.297,232,.437,579,122,.739,165,76,40,2020,Deni Avdija,74,209,SF,697,65,WAS,123,487
22,97,,48,286,.560,247,153,.591,259,94,.353,266,.470,525,108,.750,144,77,20,1682,Santi Aldama,85,143,PF,696,45,MEM,60,371
28,149,,44,357,.561,262,219,.567,386,43,.361,119,.519,505,127,.661,192,52,52,1391,Jusuf NurkiÄ,114,185,C,694,43,POR,119,471
32,233,,6,119,.486,263,167,.474,352,96,.333,288,.411,640,71,.910,78,68,40,1657,Reggie Jackson,25,114,PG,693,47,2TM,115,144
23,88,,8,148,.599,224,63,.553,114,161,.409,394,.441,508,82,.820,100,73,10,1395,Isaiah Joe,27,105,SG,691,48,OKC,39,175
23,206,,26,175,.545,281,222,.583,381,59,.312,189,.493,570,66,.805,82,80,51,2098,Ayo Dosunmu,45,182,SG,687,62,CHI,99,220
24,138,,6,68,.558,237,189,.546,346,48,.393,122,.506,468,163,.819,199,48,15,1145,Collin Sexton,37,112,PG,685,27,UTA,85,105
27,117,,31,256,.540,254,170,.545,312,84,.356,236,.464,548,91,.805,113,71,49,2077,Caleb Martin,88,145,SF,683,71,MIA,78,344
21,69,ROY-3,173,389,.721,298,297,.723,411,1,.333,3,.720,414,82,.516,159,74,40,1703,Walker Kessler,231,169,C,679,26,UTA,58,620
26,252,,10,245,.574,235,85,.525,162,150,.397,378,.435,540,58,.817,71,72,36,1894,Donte DiVincenzo,80,133,SG,678,97,GSW,112,325
19,127,,7,153,.503,269,192,.539,356,77,.302,255,.440,611,58,.829,70,66,32,1550,Malaki Branham,28,115,SG,673,33,SAS,76,181
29,283,,49,329,.524,229,66,.379,174,163,.389,419,.386,593,50,.725,69,76,53,2409,Royce O'Neale,55,239,SF,671,65,BRK,114,384
27,115,,11,151,.560,239,123,.564,218,116,.372,312,.451,530,75,.694,108,77,2,1548,Cedi Osman,25,122,SF,669,35,CLE,52,176
20,125,,31,161,.579,261,207,.590,351,54,.370,146,.525,497,90,.652,138,67,16,1394,Jonathan Kuminga,70,157,PF,666,41,GSW,95,231
22,172,,15,115,.502,228,111,.434,256,117,.371,315,.399,571,86,.843,102,56,1,1085,Bones Hyland,20,96,PG,659,39,2TM,82,135
31,91,,6,116,.575,239,116,.516,225,123,.413,298,.457,523,53,.757,70,64,0,1314,Doug McDermott,23,118,SF,654,13,SAS,58,139
24,64,,17,95,.534,236,145,.522,278,91,.365,249,.448,527,91,.858,106,56,32,1297,Lonnie Walker IV,14,71,SG,654,30,LAL,46,109
29,174,,20,134,.528,239,132,.506,261,107,.365,293,.431,554,69,.852,81,65,10,1530,Josh Richardson,41,117,SG,654,69,2TM,86,175
31,114,,8,139,.544,200,101,.459,220,99,.414,239,.436,459,153,.814,188,51,8,1122,Alec Burks,19,98,SG,652,38,DET,58,158
27,197,,29,167,.549,239,97,.425,228,142,.421,337,.423,565,31,.816,38,81,39,1810,Jevon Carter,35,158,PG,651,66,MIL,78,202
30,397,,10,189,.568,283,257,.556,462,26,.441,59,.543,521,58,.853,68,75,6,1526,T.J. McConnell,45,105,PG,650,81,IND,143,234
26,78,,14,151,.579,223,120,.548,219,103,.404,255,.470,474,101,.842,120,42,41,1199,Cameron Johnson,34,83,PF,650,50,2TM,37,185
24,162,,42,172,.525,235,179,.536,334,56,.335,167,.469,501,123,.764,161,66,66,1951,Herbert Jones,97,208,PF,649,103,NOP,88,269
29,335,,63,302,.553,252,209,.536,390,43,.410,105,.509,495,100,.735,136,69,46,1957,Kyle Anderson,66,146,PF,647,78,MIN,103,368
27,103,,20,183,.568,236,180,.557,323,56,.394,142,.508,465,119,.793,150,67,42,1452,Keita Bates-Diop,65,63,PF,647,46,SAS,56,248
22,66,,60,265,.530,242,188,.593,317,54,.283,191,.476,508,104,.759,137,68,31,1279,Jalen Smith,129,153,C,642,21,IND,72,394
26,167,,5,118,.505,228,111,.512,217,117,.334,350,.402,567,68,.872,78,68,34,1759,Gabe Vincent,27,154,PG,641,62,MIA,92,145
24,131,,31,276,.575,216,101,.546,185,115,.395,291,.454,476,94,.770,122,79,23,2045,Grant Williams,87,192,PF,641,41,BOS,82,363
19,73,,12,116,.560,248,147,.536,274,101,.390,259,.465,533,42,.894,47,72,12,1401,AJ Griffin,37,87,SF,639,42,ATL,42,153
26,240,,13,152,.535,241,185,.521,355,56,.378,148,.479,503,99,.853,116,76,11,1567,Shake Milton,39,123,SG,637,25,PHI,94,191
29,77,,14,166,.596,222,68,.576,118,154,.401,384,.442,502,39,.867,45,78,1,1512,Georges Niang,19,145,PF,637,30,PHI,54,185
27,326,,13,184,.555,247,169,.543,311,78,.382,204,.480,515,64,.831,77,62,61,1695,Monte Morris,26,75,PG,636,43,WAS,60,210
23,69,,85,336,.577,261,231,.633,365,30,.265,113,.546,478,82,.759,108,70,33,1505,Bol Bol,69,92,PF,634,30,ORL,112,405
23,184,,21,412,.580,247,218,.604,361,29,.322,90,.548,451,96,.691,139,78,65,1879,Jarred Vanderbilt,170,190,PF,619,83,2TM,97,582
32,500,DPOY-4,60,459,.570,250,210,.612,343,40,.305,131,.527,474,77,.713,108,73,73,2297,Draymond Green,66,229,PF,617,74,GSW,204,525
36,189,,61,317,.627,228,83,.539,154,145,.446,325,.476,479,15,.714,21,63,63,1922,Al Horford,73,121,C,616,30,BOS,37,390
36,281,,21,182,.514,196,89,.509,175,107,.345,310,.404,485,116,.859,135,55,44,1718,Kyle Lowry,43,143,PG,615,57,MIA,103,225
19,142,,23,200,.483,250,217,.519,418,33,.246,134,.453,552,81,.698,116,56,53,1458,Jeremy Sochan,95,138,PF,614,43,SAS,97,295
19,75,,59,366,.648,258,258,.652,396,0,.000,2,.648,398,96,.611,157,67,31,1670,Jalen Duren,229,182,C,612,44,DET,92,595
30,99,,7,186,.564,200,90,.439,205,110,.445,247,.442,452,94,.904,104,74,5,1506,Damion Lee,39,118,SG,604,30,PHO,78,225
21,78,,7,87,.497,201,150,.464,323,51,.383,133,.441,456,151,.868,174,57,4,948,Cam Thomas,8,55,SG,604,20,BRK,63,95
25,84,,13,190,.564,198,147,.631,233,51,.313,163,.500,396,153,.841,182,57,18,1109,Moritz Wagner,69,136,C,600,37,ORL,68,259
32,117,,62,281,.556,228,128,.518,247,100,.395,253,.456,500,32,.711,45,79,60,1948,Torrey Craig,145,179,PF,588,50,PHO,73,426
25,31,,30,253,.659,230,204,.658,310,26,.441,59,.623,369,93,.738,126,59,26,1081,Thomas Bryant,86,102,C,579,16,2TM,38,339
26,207,,50,486,.630,242,242,.632,383,0,.000,1,.630,384,94,.606,155,82,70,1958,Kevon Looney,274,225,C,578,52,GSW,45,760
21,70,,34,288,.518,195,128,.542,236,67,.327,205,.442,441,110,.738,149,50,47,1414,Isaiah Stewart,115,133,C,567,20,DET,68,403
31,101,,13,141,.618,201,59,.551,107,142,.426,333,.457,440,18,.643,28,74,33,1527,Joe Harris,23,140,SF,562,34,BRK,41,164
27,66,,31,232,.565,187,100,.595,168,87,.363,240,.458,408,101,.815,124,74,0,1247,Trey Lyles,68,97,PF,562,27,SAC,64,300
31,108,,13,251,.569,192,41,.562,73,151,.380,397,.409,470,26,.703,37,78,55,2364,Reggie Bullock,32,166,SF,561,54,DAL,36,283
32,99,,7,87,.568,208,114,.525,217,94,.405,232,.463,449,51,.927,55,61,7,1211,Seth Curry,13,96,SG,561,36,BRK,51,100
26,72,,37,218,.658,229,228,.665,343,1,.167,6,.656,349,99,.723,137,56,8,1090,Brandon Clarke,92,131,PF,558,34,MEM,55,310
29,100,,36,202,.505,196,82,.503,163,114,.337,338,.391,501,45,.763,59,66,66,2009,Dorian Finney-Smith,114,144,PF,551,55,2TM,62,316
24,186,,10,113,.496,201,118,.488,242,83,.336,247,.411,489,65,.813,80,61,10,1310,Jose Alvarado,28,125,PG,550,67,NOP,81,141
22,103,,5,127,.626,205,137,.643,213,68,.402,169,.537,382,68,.723,94,60,21,1539,Josh Green,55,156,SG,546,42,DAL,72,182
26,91,,5,143,.666,188,55,.487,113,133,.494,269,.492,382,37,.949,39,59,14,1315,Luke Kennard,15,82,SG,546,32,2TM,46,158
24,88,,14,178,.533,194,108,.462,234,86,.408,211,.436,445,68,.791,86,62,14,1188,Jordan Nwora,51,74,SF,542,24,2TM,66,229
23,95,,16,246,.545,200,93,.505,184,107,.381,281,.430,465,34,.872,39,76,45,1860,Troy Brown Jr.,62,120,SF,541,59,LAL,49,308
27,196,,16,103,.512,161,42,.452,93,119,.352,338,.374,431,98,.748,131,73,8,1338,Devonte' Graham,19,79,PG,539,45,2TM,53,122
25,38,,71,269,.631,197,196,.628,312,1,1.000,1,.629,313,137,.749,183,65,9,1217,Nick Richards,147,154,C,532,11,CHO,59,416
24,105,,34,142,.471,162,96,.442,217,66,.335,197,.391,414,139,.724,192,72,26,1350,Josh Okogie,109,114,SG,529,56,PHO,63,251
21,155,,27,106,.493,186,120,.496,242,66,.327,202,.419,444,86,.723,119,53,19,1246,Jalen Suggs,55,120,SG,524,67,ORL,94,161
24,55,,16,137,.580,215,210,.593,354,5,.238,21,.573,375,87,.588,148,56,0,996,Hamidou Diallo,57,124,SF,522,53,DET,71,194
31,95,,10,132,.532,200,105,.507,207,95,.368,258,.430,465,27,.794,34,63,9,1330,Terrence Ross,22,97,SG,522,35,2TM,43,154
25,103,,102,286,.651,214,207,.655,316,7,.389,18,.641,334,83,.664,125,78,28,1584,Drew Eubanks,132,169,C,518,40,POR,67,418
21,120,,11,128,.474,197,116,.475,244,81,.315,257,.393,501,42,.764,55,67,5,1183,Tre Mann,27,99,PG,517,40,OKC,62,155
25,71,,21,169,.631,180,40,.656,61,140,.418,335,.455,396,12,.706,17,80,8,1290,Sam Hauser,35,99,SF,512,29,BOS,30,204
34,116,,12,340,.506,165,66,.516,128,99,.334,296,.389,424,80,.879,91,62,20,1240,Kevin Love,59,97,PF,509,16,2TM,70,399
23,50,,30,228,.521,196,167,.564,296,29,.269,108,.485,404,87,.702,124,55,12,1140,Precious Achiuwa,100,102,C,508,31,TOR,59,328
31,69,,26,165,.732,197,197,.746,264,0,.000,5,.732,269,112,.667,168,76,64,1458,Dwight Powell,149,209,C,506,48,DAL,65,314
23,36,,30,175,.554,202,183,.579,316,19,.288,66,.529,382,81,.750,108,42,25,990,Marvin Bagley III,94,81,C,504,19,DET,46,269
24,66,,12,158,.548,187,102,.593,172,85,.344,247,.446,419,38,.809,47,67,5,1050,Obi Toppin,29,68,PF,497,23,NYK,38,187
27,90,,7,94,.512,191,112,.493,227,79,.354,223,.424,450,35,.854,41,70,2,964,Kendrick Nunn,15,66,SG,496,28,2TM,66,109
28,214,,8,94,.490,188,120,.448,268,68,.368,185,.415,453,49,.766,64,48,15,968,Cameron Payne,12,88,PG,493,33,PHO,81,106
28,84,,15,117,.565,177,103,.557,185,74,.381,194,.467,379,65,.844,77,54,4,1192,Taurean Prince,15,123,PF,493,28,MIN,69,132
22,87,,30,135,.582,175,113,.617,183,62,.363,171,.494,354,78,.757,103,76,46,1652,Isaac Okoro,52,158,SF,490,56,CLE,42,187
24,80,,15,142,.579,186,138,.573,241,48,.393,122,.512,363,59,.831,71,70,14,1297,Aaron Wiggins,68,110,SG,479,39,OKC,55,210
34,121,,44,237,.583,160,36,.563,64,124,.391,317,.420,381,34,.708,48,78,19,1709,Nicolas Batum,62,149,PF,478,54,LAC,50,299
25,261,,25,140,.438,186,162,.475,341,24,.216,111,.412,452,78,.736,106,54,15,1390,Dennis Smith Jr.,27,122,PG,474,75,CHO,82,167
22,67,,15,78,.532,165,84,.532,158,81,.355,228,.427,386,56,.812,69,59,22,1209,Ochai Agbaji,43,99,SG,467,16,UTA,41,121
30,77,,11,233,.521,165,56,.566,99,109,.339,322,.392,421,27,.659,41,61,33,1443,Pat Connaughton,50,69,SF,466,37,MIL,33,283
21,59,,19,143,.506,180,115,.553,208,65,.307,212,.429,420,41,.631,65,70,4,1258,David Roddy,50,107,PF,466,29,MEM,57,193
22,130,,12,196,.599,181,156,.602,259,25,.391,64,.560,323,72,.720,100,62,12,1182,Trendon Watford,42,118,PF,459,32,POR,71,238
27,68,,30,161,.559,178,157,.621,253,21,.250,84,.528,337,79,.752,105,69,4,979,Jock Landale,119,126,C,456,16,PHO,59,280
21,51,,93,169,.566,179,177,.582,304,2,.143,14,.563,318,95,.651,146,63,12,1042,Isaiah Jackson,113,154,C,455,31,IND,51,282
24,185,,15,89,.533,181,118,.584,202,63,.320,197,.454,399,25,.806,31,80,9,1447,Davion Mitchell,16,112,PG,450,44,SAC,62,105
21,30,,27,194,.563,189,185,.580,319,4,.200,20,.558,339,68,.701,97,45,22,867,James Wiseman,73,108,C,450,7,2TM,51,267
30,146,,12,112,.484,160,90,.471,191,70,.330,212,.397,403,59,.747,79,42,2,1106,Victor Oladipo,16,99,SG,449,57,MIA,87,128
30,119,,37,248,.633,186,172,.654,263,14,.333,42,.610,305,55,.696,79,65,1,1381,Larry Nance Jr.,106,133,C,441,56,NOP,42,354
36,69,,17,106,.534,160,130,.580,224,30,.288,104,.488,328,87,.744,117,56,4,1091,Jeff Green,38,99,PF,437,18,DEN,46,144
24,53,,109,288,.671,188,188,.671,280,0,,0,.671,280,59,.484,122,59,58,1591,Mitchell Robinson,267,160,C,435,56,NYK,41,555
25,67,,12,119,.545,154,65,.537,121,89,.366,243,.423,364,34,.791,43,64,5,841,Terence Davis,20,104,SG,431,43,SAC,53,139
24,96,,29,186,.621,188,184,.632,291,4,.267,15,.614,306,49,.551,89,61,29,1180,Xavier Tillman Sr.,121,97,C,429,58,MEM,44,307
31,217,,9,85,.527,150,80,.468,171,70,.389,180,.427,351,57,.792,72,62,2,1227,Cory Joseph,21,88,PG,427,34,DET,56,106
28,105,,14,164,.590,179,129,.608,212,50,.373,134,.517,346,17,.436,39,53,10,1206,Kenrich Williams,97,112,PF,425,45,OKC,32,261
20,65,,7,78,.533,146,83,.469,177,63,.404,156,.438,333,65,.823,79,48,5,708,Jaden Hardy,11,64,SG,420,17,DAL,46,89
25,96,,20,159,.588,148,75,.652,115,73,.367,199,.471,314,46,.767,60,62,4,1195,Anthony Lamb,56,134,SF,415,28,GSW,54,215
34,194,,41,203,.511,144,64,.529,121,80,.335,239,.400,360,47,.723,65,67,67,1816,Patrick Beverley,44,187,PG,415,63,2TM,60,247
23,33,,12,143,.556,152,87,.596,146,65,.349,186,.458,332,46,.767,60,63,5,952,Kevin Knox,34,95,SF,415,24,2TM,50,177
24,168,,26,148,.501,158,120,.511,235,38,.322,118,.448,353,53,.768,69,62,7,1106,Jordan Goodwin,57,95,PG,407,58,WAS,57,205
24,102,,64,327,.547,175,167,.576,290,8,.216,37,.535,327,48,.676,71,82,8,1626,Isaiah Hartenstein,209,213,C,406,53,NYK,66,536
29,33,,27,306,.606,166,166,.613,271,0,.000,3,.606,274,67,.536,125,67,0,849,Andre Drummond,138,117,C,399,45,CHI,75,444
24,44,,13,156,.461,123,75,.457,164,48,.310,155,.386,319,104,.717,145,65,2,1083,Oshae Brissett,62,79,PF,398,33,IND,34,218
28,59,,12,77,.603,138,44,.494,89,94,.431,218,.450,307,27,.900,30,48,42,1184,Gary Harris,21,93,SG,397,45,ORL,28,98
21,83,,34,231,.537,158,128,.587,218,30,.288,104,.491,322,49,.628,78,70,6,1042,Jalen Johnson,51,113,SF,395,38,ATL,41,282
21,18,,45,211,.637,160,160,.637,251,0,,0,.637,251,67,.691,97,43,17,828,Mark Williams,93,94,C,387,28,CHO,40,304
31,50,,24,166,.587,131,50,.588,85,81,.391,207,.449,292,40,.769,52,63,9,945,Mike Muscala,37,98,C,383,15,2TM,23,203
32,112,,13,122,.470,138,72,.391,184,66,.367,180,.379,364,37,.787,47,56,2,993,Will Barton,15,56,SG,379,28,2TM,48,137
27,68,,10,66,.519,124,93,.511,182,31,.356,87,.461,269,99,.917,108,53,12,736,Edmond Sumner,13,83,SG,378,31,BRK,50,79
28,193,DPOY-11,46,154,.551,130,75,.556,135,55,.364,151,.455,286,59,.808,73,67,36,1575,Alex Caruso,42,159,PG,374,98,CHI,77,196
21,73,,15,51,.497,153,132,.550,240,21,.236,89,.465,329,45,.750,60,64,2,786,Josh Christopher,20,59,SG,372,33,HOU,60,71
25,36,,35,170,.615,155,145,.647,224,10,.278,36,.596,260,52,.619,84,68,2,1024,Wenyen Gabriel,116,144,C,372,26,LAL,46,286
30,194,,17,122,.545,138,97,.564,172,41,.345,119,.474,291,52,.867,60,50,14,1221,Delon Wright,58,59,PG,369,92,WAS,44,180
32,51,,23,133,.623,136,94,.667,141,42,.378,111,.540,252,52,.776,67,57,1,797,JaMychal Green,72,105,PF,366,25,GSW,52,205
36,151,,4,65,.499,141,89,.468,190,52,.359,145,.421,335,31,.689,45,58,0,870,Goran DragiÄ,16,65,PG,365,13,2TM,63,81
26,100,,25,246,.525,138,78,.545,143,60,.339,177,.431,320,28,.778,36,72,23,1494,John Konchar,64,112,SF,364,77,MEM,37,310
24,108,,21,86,.547,131,70,.515,136,61,.384,159,.444,295,40,.667,60,59,3,884,Nickeil Alexander-Walker,15,88,SG,363,32,2TM,55,101
25,64,,9,96,.452,123,68,.428,159,55,.316,174,.369,333,61,.847,72,46,12,897,Chris Duarte,19,65,SF,362,25,IND,41,115
28,74,,7,154,.540,127,82,.506,162,45,.391,115,.458,277,63,.829,76,57,12,806,Dario Å ariÄ,53,99,C,362,20,2TM,55,207
29,97,,46,271,.597,157,157,.599,262,0,.000,1,.597,263,47,.364,129,42,42,1133,Steven Adams,214,98,C,361,36,MEM,79,485
21,59,,17,133,.554,143,109,.565,193,34,.354,96,.495,289,40,.625,64,76,6,1181,Christian Braun,48,101,SG,360,41,DEN,35,181
22,50,,20,114,.538,134,76,.524,145,58,.367,158,.442,303,33,.717,46,54,4,976,Nassir Little,27,66,SF,359,20,POR,36,141
24,41,,28,115,.545,120,46,.541,85,74,.365,203,.417,288,32,.821,39,52,22,1199,Isaiah Livers,28,103,PF,346,28,DET,30,143
27,42,,8,55,.470,115,52,.430,121,63,.330,191,.369,312,35,.795,44,52,6,766,Simone Fontecchio,31,62,SF,328,15,UTA,39,86
25,33,,19,159,.500,129,99,.513,193,30,.316,95,.448,288,40,.702,57,62,25,1120,Lamar Stevens,48,79,SF,328,27,CLE,27,207
24,46,,43,167,.585,117,69,.590,117,48,.387,124,.485,241,41,.661,62,49,7,769,Mo Bamba,58,105,C,323,13,2TM,30,225
28,48,,17,111,.621,114,54,.557,97,60,.444,135,.491,232,34,.723,47,58,1,928,Yuta Watanabe,30,80,SF,322,25,BRK,22,141
25,40,,21,151,.610,129,120,.663,181,9,.237,38,.589,219,54,.740,73,66,0,689,Chimezie Metu,47,81,PF,321,22,SAC,32,198
29,33,,25,92,.598,125,125,.616,203,0,.000,6,.598,209,70,.693,101,57,7,681,Montrezl Harrell,67,75,C,320,17,PHI,35,159
25,34,,37,93,.559,115,88,.587,150,27,.338,80,.500,230,62,.738,84,64,0,893,Derrick Jones Jr.,60,86,PF,319,29,CHI,25,153
35,150,,6,115,.603,108,25,.556,45,83,.409,203,.435,248,18,.857,21,46,0,1044,Joe Ingles,13,74,SF,317,33,MIL,55,128
29,40,,12,95,.530,132,110,.542,203,22,.328,67,.489,270,28,.800,35,42,0,687,T.J. Warren,26,65,PF,314,22,2TM,20,121
25,135,,5,71,.560,118,83,.546,152,35,.389,90,.488,242,38,.927,41,45,2,816,Ty Jerome,7,64,SG,309,23,GSW,30,78
20,51,,7,77,.584,108,59,.641,92,49,.363,135,.476,227,37,.698,53,63,3,817,Moses Moody,28,54,SG,302,18,GSW,34,105
21,54,,9,69,.517,102,61,.504,121,41,.353,116,.430,237,57,.750,76,47,3,750,R.J. Hampton,18,51,SG,302,27,2TM,42,87
25,80,,14,104,.570,108,65,.580,112,43,.374,115,.476,227,38,.927,41,60,9,889,Vlatko ÄanÄar,24,84,PF,297,22,DEN,37,128
23,50,,13,57,.498,121,105,.530,198,16,.262,61,.467,259,39,.696,56,43,21,844,Romeo Langford,57,67,SG,297,24,SAS,30,114
21,152,,12,109,.457,102,74,.465,159,28,.295,95,.402,254,63,.851,74,44,7,854,ThÃ©o Maledon,14,61,PG,295,37,CHO,59,123
36,57,,18,130,.437,109,76,.484,157,33,.254,130,.380,287,42,.857,49,56,0,816,Rudy Gay,33,68,PF,293,19,UTA,37,163
25,53,,32,100,.542,110,56,.533,105,54,.365,148,.435,253,19,.679,28,71,28,1200,Matisse Thybulle,40,113,SF,293,83,2TM,24,140
22,43,,11,109,.518,110,73,.533,137,37,.333,111,.444,248,35,.833,42,43,20,814,Jeremiah Robinson-Earl,71,71,PF,292,24,OKC,19,180
26,256,,24,223,.566,133,133,.571,233,0,.000,2,.566,235,25,.439,57,42,33,1105,Ben Simmons,40,139,PG,291,54,BRK,97,263
32,57,,33,135,.563,102,48,.516,93,54,.397,136,.445,229,30,.750,40,48,0,779,Robert Covington,31,86,PF,288,38,LAC,32,166
20,76,,12,197,.534,102,56,.463,121,46,.407,113,.436,234,38,.704,54,49,36,914,Jaylin Williams,44,111,C,288,28,OKC,37,241
23,27,,51,150,.596,124,123,.606,203,1,.167,6,.593,209,38,.745,51,69,2,755,Paul Reed,112,123,C,287,46,PHI,45,262
22,18,,23,73,.605,110,93,.710,131,17,.262,65,.561,196,40,.645,62,53,5,728,Zeke Nnaji,65,105,PF,277,17,DEN,31,138
25,64,,1,63,.527,101,45,.495,91,56,.364,154,.412,245,12,.750,16,48,3,643,Payton Pritchard,25,37,PG,270,14,BOS,40,88
29,44,,9,85,.566,93,56,.644,87,37,.336,110,.472,197,45,.750,60,56,5,807,Danuel House Jr.,9,69,SF,268,14,PHI,26,94
28,46,,0,61,.504,88,25,.556,45,63,.328,192,.371,237,29,.906,32,42,1,691,Duncan Robinson,8,77,SF,268,14,MIA,28,69
22,35,,7,77,.492,96,49,.485,101,47,.331,142,.395,243,27,.730,37,52,11,701,MarJon Beauchamp,38,71,SF,266,21,MIL,45,115
37,60,,15,200,.549,96,41,.482,85,55,.393,140,.427,225,19,.826,23,75,75,1920,P.J. Tucker,95,180,PF,266,39,PHI,44,295
30,56,,88,171,.578,119,119,.578,206,0,,0,.578,206,25,.357,70,61,14,874,Bismack Biyombo,89,114,C,263,18,PHO,51,260
23,62,,12,115,.487,97,67,.511,131,30,.303,99,.422,230,39,.684,57,43,7,660,Sandro Mamukelashvili,70,52,C,263,14,2TM,35,185
20,36,,23,116,.481,95,56,.487,115,39,.317,123,.399,238,33,.702,47,69,8,969,JT Thor,36,66,PF,262,22,CHO,44,152
27,53,,46,111,.674,113,110,.701,157,3,.231,13,.665,170,32,.821,39,69,0,804,Luke Kornet,86,81,C,261,11,BOS,25,197
26,26,,5,62,.520,73,10,.476,21,63,.350,180,.363,201,48,.906,53,54,0,686,Garrison Mathews,11,62,SG,257,24,2TM,19,73
30,75,,4,78,.538,91,48,.558,86,43,.350,123,.435,209,30,.769,39,52,10,1016,Austin Rivers,5,80,SG,255,28,MIN,23,83
28,53,,22,94,.496,84,27,.500,54,57,.329,173,.370,227,26,.839,31,60,2,915,Ish Wainright,45,117,SF,251,38,PHO,22,139
26,89,,12,49,.500,92,56,.424,132,36,.409,88,.418,220,27,.844,32,63,6,845,Aaron Holiday,25,79,PG,247,37,ATL,36,74
24,70,,4,61,.457,87,40,.367,109,47,.353,133,.360,242,25,.758,33,53,2,691,Malachi Flynn,15,65,PG,246,21,TOR,25,76
20,54,,6,73,.460,80,54,.443,122,26,.325,80,.396,202,60,.750,80,46,7,787,Bryce McGowens,20,48,SG,246,15,CHO,43,93
34,75,,5,95,.561,108,102,.622,164,6,.176,34,.545,198,18,.692,26,54,9,795,Thaddeus Young,71,88,PF,240,54,TOR,42,166
26,43,,17,131,.516,93,56,.523,107,37,.339,109,.431,216,13,.464,28,54,11,969,Haywood Highsmith,57,82,PF,236,36,MIA,45,188
22,34,,19,93,.561,86,83,.654,127,3,.103,29,.551,156,58,.699,83,47,2,610,Jaxson Hayes,39,67,C,233,20,NOP,31,132
36,110,,6,70,.572,78,44,.620,71,34,.358,95,.470,166,42,.764,55,46,1,834,George Hill,15,55,SG,232,26,2TM,34,85
19,134,,11,152,.483,87,60,.492,122,27,.314,86,.418,208,26,.650,40,59,11,1042,Dyson Daniels,36,99,PG,227,43,NOP,57,188
21,37,,32,101,.561,93,87,.544,160,6,.545,11,.544,171,35,.636,55,48,3,552,Day'Ron Sharpe,99,89,C,227,15,BRK,42,200
20,132,,7,80,.426,81,41,.423,97,40,.286,140,.342,237,24,.667,36,57,7,914,Daishen Nix,18,59,PG,226,31,HOU,86,98
20,64,,29,187,.554,86,62,.525,118,24,.407,59,.486,177,29,.617,47,75,1,970,Usman Garuba,120,135,C,225,44,HOU,47,307
22,38,,34,104,.508,83,63,.485,130,20,.377,53,.454,183,38,.543,70,43,1,616,Darius Bazley,34,44,C,224,22,2TM,27,138
22,72,,8,37,.451,77,37,.457,81,40,.299,134,.358,215,28,.667,42,64,2,760,Miles McBride,13,60,PG,222,37,NYK,25,50
20,34,,13,83,.460,83,67,.472,142,16,.286,56,.419,198,34,.756,45,56,0,619,Jabari Walker,48,69,SF,216,10,POR,29,131
25,28,,11,59,.556,70,12,.750,16,58,.358,162,.393,178,16,.800,20,41,0,531,Lindy Waters III,16,42,SG,214,14,OKC,10,75
30,21,,8,43,.603,69,14,.737,19,55,.390,141,.431,160,13,.867,15,45,1,492,DÄvis BertÄns,10,53,PF,206,11,DAL,10,53
26,37,,21,130,.540,73,28,.560,50,45,.354,127,.412,177,15,.652,23,44,13,891,Dean Wade,20,89,PF,206,28,CLE,17,150
33,41,,19,50,.490,77,31,.508,61,46,.322,143,.377,204,5,.625,8,46,2,706,Justin Holiday,5,68,SF,205,19,2TM,22,55
30,34,,12,62,.553,71,67,.650,103,4,.138,29,.538,132,49,.731,67,59,8,624,Anthony Gill,37,70,PF,195,7,WAS,15,99
20,30,,7,65,.489,66,20,.435,46,46,.338,136,.363,182,15,.833,18,51,4,812,Caleb Houstan,34,63,SF,193,12,ORL,18,99
35,11,,26,77,.648,80,78,.650,120,2,.400,5,.640,125,24,.585,41,42,7,355,JaVale McGee,30,54,C,186,4,DAL,36,107
22,31,,57,87,.483,72,71,.514,138,1,.083,12,.480,150,37,.627,59,58,19,802,Christian Koloko,84,128,C,182,21,TOR,20,171
36,34,,13,79,.484,58,19,.528,36,39,.315,124,.363,160,24,.857,28,52,0,820,Wesley Matthews,34,71,SF,179,20,MIL,18,113
24,25,,28,143,.776,83,83,.783,106,0,.000,1,.776,107,12,.750,16,52,16,812,Jericho Sims,99,96,C,178,15,NYK,27,242
25,53,,5,36,.424,56,45,.429,105,11,.275,40,.386,145,49,.778,63,50,9,625,Amir Coffey,17,50,SF,172,7,LAC,21,53
24,38,,7,86,.490,67,49,.516,95,18,.300,60,.432,155,20,.488,41,42,2,474,Isaiah Roby,21,53,PF,172,18,SAS,31,107
33,61,,9,108,.573,63,40,.625,64,23,.348,66,.485,130,21,.656,32,41,16,569,Blake Griffin,47,75,C,170,14,BOS,22,155
37,34,,12,61,.552,65,57,.564,101,8,.333,24,.520,125,30,.714,42,49,2,480,Taj Gibson,32,84,C,168,15,WAS,26,93
26,148,,4,47,.503,61,37,.552,67,24,.308,78,.421,145,15,.833,18,43,0,678,Jordan McLaughlin,15,28,PG,161,32,MIN,33,62
22,15,,30,86,.575,67,63,.624,101,4,.211,19,.558,120,19,.731,26,46,0,550,Kai Jones,37,65,C,157,17,CHO,31,123
30,79,,4,36,.573,57,45,.662,68,12,.286,42,.518,110,31,.912,34,48,1,505,Raul Neto,10,49,PG,157,17,CLE,24,46
29,65,,10,96,.476,64,56,.560,100,8,.186,43,.448,143,19,.792,24,52,9,700,Juan Toscano-Anderson,28,80,SF,155,16,2TM,34,124
27,15,,21,80,.698,55,45,.652,69,10,.588,17,.640,86,22,.759,29,41,1,477,Damian Jones,42,55,C,142,8,2TM,23,122
24,58,,7,55,.428,48,31,.477,65,17,.254,67,.364,132,22,.667,33,47,5,607,Frank Ntilikina,7,65,SG,135,16,DAL,29,62
29,9,,11,51,.646,55,50,.617,81,5,.625,8,.618,89,15,.789,19,42,1,348,Richaun Holmes,29,50,C,130,3,SAC,14,80
19,21,,7,68,.538,44,18,.409,44,26,.419,62,.415,106,14,.875,16,41,3,512,Max Christie,7,33,SG,128,9,LAL,13,75
27,25,,6,96,.496,48,31,.660,47,17,.254,67,.421,114,9,.563,16,42,10,614,Juancho HernangÃ³mez,27,43,PF,122,16,TOR,15,123
34,100,,7,49,.405,52,50,.420,119,2,.167,12,.397,131,2,.500,4,43,0,398,Ish Smith,5,33,PG,108,8,DEN,44,54
27,23,,4,49,.435,28,11,.289,38,17,.370,46,.333,84,16,.667,24,43,1,342,Davon Reed,10,39,SG,89,15,2TM,20,59
