age,ast,awards,blk,drb,efg_pct,fg,fg2,fg2_pct,fg2a,fg3,fg3_pct,fg3a,fg_pct,fga,ft,ft_pct,fta,games,games_started,mp,name_display,orb,pf,pos,pts,stl,team_name_abbr,tov,trb
24,686,,38,588,.573,804,520,.573,908,284,.382,744,.487,1652,478,.786,608,70,70,2624,Luka DonÄiÄ,59,149,PG,2370,99,DAL,282,647
25,465,"MVP-3,CPOY-6,AS,NBA1",67,350,.567,796,701,.576,1218,95,.353,269,.535,1487,567,.874,649,75,75,2553,Shai Gilgeous-Alexander,65,184,PG,2254,150,OKC,162,415
29,476,"MVP-2,DPOY-7,CPOY-3,AS,NBA1",79,645,.624,837,803,.645,1245,34,.274,124,.611,1369,514,.657,782,73,73,2567,Giannis Antetokounmpo,196,210,PF,2222,87,MIL,250,841
27,519,"MVP-4,DPOY-9,CPOY-12,AS,NBA1",13,235,.543,790,579,.516,1122,211,.401,526,.479,1648,421,.847,497,77,77,2726,Jalen Brunson,43,144,PG,2212,70,NYK,186,278
28,708,"MVP-5,CPOY-5,AS,NBA2",68,753,.612,822,739,.626,1180,83,.359,231,.583,1411,358,.817,438,79,79,2737,Nikola JokiÄ,223,194,C,2085,108,DEN,237,976
22,405,"MVP-1,CPOY-4,AS,NBA1",42,378,.522,718,528,.515,1026,190,.357,532,.461,1558,423,.836,506,79,78,2770,Anthony Edwards,52,141,SG,2049,101,MIN,241,430
35,378,"MVP-7,CPOY-8,AS,NBA2",91,454,.581,751,583,.567,1029,168,.413,407,.523,1436,362,.856,423,75,75,2791,Kevin Durant,41,133,PF,2032,69,PHO,244,495
25,364,"MVP-9,AS,NBA2",43,534,.552,672,443,.542,817,229,.376,609,.471,1426,414,.833,497,74,74,2645,Jayson Tatum,67,145,PF,1987,75,BOS,188,601
26,418,"MVP-6,CPOY-9,AS,NBA1",31,273,.534,720,506,.522,969,214,.369,580,.465,1549,312,.738,423,74,74,2659,De'Aaron Fox,67,193,PG,1966,150,SAC,194,340
35,379,CPOY-12,28,293,.573,650,293,.515,569,357,.408,876,.450,1445,299,.923,324,74,74,2421,Stephen Curry,37,117,PG,1956,54,GSW,210,330
34,421,"CPOY-1,AS,NBA3",45,297,.507,650,575,.509,1130,75,.333,225,.480,1355,522,.853,612,79,79,2989,DeMar DeRozan,43,161,SF,1897,90,CHI,135,340
30,266,CPOY-2,178,722,.567,713,684,.582,1176,29,.271,107,.556,1283,421,.816,516,76,76,2700,Anthony Davis,239,177,C,1876,91,LAL,159,961
27,472,"DPOY-4,AS,NBA2",28,252,.550,642,490,.552,887,152,.364,418,.492,1305,405,.886,457,68,68,2447,Devin Booker,56,206,PG,1841,61,PHO,178,308
39,589,"AS,NBA3",38,457,.599,685,536,.592,906,149,.410,363,.540,1269,303,.750,404,71,71,2504,LeBron James,61,78,PF,1822,89,LAL,245,518
23,433,"CPOY-10,AS,NBA3",33,222,.524,638,426,.501,850,212,.373,569,.450,1419,328,.868,378,70,70,2626,Tyrese Maxey,36,151,PG,1816,69,PHI,116,258
21,431,"MIP-1,AS",47,472,.497,640,521,.493,1056,119,.339,351,.455,1407,405,.725,559,80,80,2799,Paolo Banchero,82,153,PF,1804,71,ORL,247,554
33,508,AS,18,284,.510,541,321,.490,655,220,.354,622,.424,1277,473,.920,514,73,73,2579,Damian Lillard,36,134,PG,1775,72,MIL,193,320
27,502,"CPOY-11,AS",24,354,.528,672,471,.518,909,201,.363,554,.459,1463,208,.794,262,78,78,2783,Dejounte Murray,62,138,SG,1753,111,ATL,201,416
29,342,,25,426,.569,681,596,.581,1025,85,.346,246,.536,1271,290,.732,396,80,80,2657,Pascal Siakam,139,193,PF,1737,63,2TM,141,565
29,190,,10,192,.559,325,279,.584,478,46,.317,145,.522,623,169,.758,223,39,39,1354,Pascal Siakam,54,87,PF,865,32,TOR,83,246
29,152,,15,234,.579,356,317,.580,547,39,.386,101,.549,648,121,.699,173,41,41,1303,Pascal Siakam,85,106,PF,872,31,IND,58,319
33,262,,37,351,.569,582,339,.523,648,243,.413,588,.471,1236,264,.907,291,74,74,2502,Paul George,37,202,PF,1671,113,LAC,153,388
32,244,AS,59,332,.585,610,470,.569,826,140,.417,336,.525,1162,253,.885,286,68,68,2330,Kawhi Leonard,84,97,SF,1613,111,LAC,119,416
27,249,"AS,NBA2",37,303,.557,627,482,.570,846,145,.354,410,.499,1256,211,.703,300,70,70,2343,Jaylen Brown,84,185,SF,1610,83,BOS,166,387
21,291,AS,28,382,.498,563,362,.498,727,201,.332,605,.423,1332,283,.804,352,82,82,2601,Jalen Green,41,115,SG,1610,66,HOU,191,423
27,299,,30,304,.521,564,344,.490,702,220,.372,592,.436,1294,258,.814,317,82,82,2854,Mikal Bridges,68,116,SF,1606,81,BRK,164,372
23,352,,47,284,.573,624,618,.574,1076,6,.333,18,.570,1094,347,.702,494,70,70,2207,Zion Williamson,122,159,PF,1601,77,NOP,193,406
27,673,,48,826,.609,634,601,.613,981,33,.379,87,.594,1068,292,.704,415,82,82,2928,Domantas Sabonis,294,250,C,1593,74,SAC,272,1120
28,296,"MVP-8,DPOY-10,NBA3",49,402,.521,608,457,.530,863,151,.336,450,.463,1313,186,.775,240,70,70,2281,Kyle Kuzma,62,153,PF,1553,37,WAS,192,464
20,274,,254,594,.519,551,423,.534,792,128,.325,394,.465,1186,292,.796,367,71,71,2106,Victor Wembanyama,161,153,C,1522,88,SAS,260,755
23,405,"ROY-1,DPOY-2",18,314,.534,541,332,.508,653,209,.376,556,.447,1209,218,.838,260,79,78,2881,Coby White,44,186,PG,1509,53,CHI,166,358
31,299,,28,246,.573,562,389,.548,710,173,.411,421,.497,1131,190,.905,210,58,58,2030,Kyrie Irving,44,112,SG,1487,74,DAL,106,290
24,154,CPOY-7,106,280,.494,516,399,.501,796,117,.320,366,.444,1162,337,.808,417,66,66,2124,Jaren Jackson Jr.,85,235,C,1486,80,MEM,160,365
22,192,,16,186,.503,526,382,.481,794,144,.364,396,.442,1190,286,.856,334,66,51,2075,Cam Thomas,28,138,SG,1482,45,BRK,124,214
27,333,,30,234,.545,503,321,.539,595,182,.368,494,.462,1089,275,.865,318,55,55,1942,Donovan Mitchell,46,118,SG,1463,101,CLE,154,280
25,383,AS,18,134,.549,506,378,.530,713,128,.394,325,.487,1038,318,.859,370,78,51,2075,Collin Sexton,71,154,SG,1458,62,UTA,165,205
25,231,,33,434,.527,559,402,.529,760,157,.349,450,.462,1210,174,.825,211,69,67,2581,Miles Bridges,71,118,SF,1449,65,CHO,138,505
22,269,,28,309,.525,528,434,.570,762,94,.281,334,.482,1096,271,.850,319,72,72,2337,Franz Wagner,72,168,SF,1421,76,ORL,137,381
22,464,,22,235,.500,524,405,.487,832,119,.355,335,.449,1167,238,.869,274,62,62,2074,Cade Cunningham,33,153,PG,1405,56,DET,212,268
23,752,,48,236,.570,500,305,.595,513,195,.364,535,.477,1048,194,.855,227,69,68,2224,Tyrese Haliburton,35,75,PG,1389,83,IND,159,271
25,583,"AS,NBA3",11,126,.516,433,258,.479,539,175,.373,469,.430,1008,348,.855,407,54,54,1942,Trae Young,23,109,PG,1389,72,ATL,235,149
33,176,AS,35,219,.551,490,222,.503,441,268,.387,692,.432,1133,127,.927,137,77,63,2284,Klay Thompson,35,127,SF,1375,50,GSW,117,254
33,254,,60,591,.522,586,494,.550,898,92,.294,313,.484,1211,106,.822,129,76,74,2610,Nikola VuÄeviÄ,210,190,C,1370,50,CHI,120,801
27,482,,36,208,.560,492,266,.497,535,226,.415,545,.456,1080,159,.828,192,76,69,2484,D'Angelo Russell,28,156,PG,1369,69,LAL,156,236
26,278,,66,578,.529,530,515,.528,975,15,.357,42,.521,1017,292,.755,387,71,71,2416,Bam Adebayo,159,159,C,1367,81,MIA,162,737
21,200,"DPOY-3,AS",190,519,.598,505,376,.623,604,129,.370,349,.530,953,218,.793,275,82,82,2413,Chet Holmgren,129,197,C,1357,53,OKC,131,648
24,343,ROY-2,25,180,.491,490,306,.492,622,184,.326,564,.413,1186,192,.877,219,78,66,2346,Jordan Poole,32,244,SG,1356,86,WAS,188,212
25,122,,53,459,.586,522,302,.575,525,220,.397,554,.484,1079,92,.836,110,81,81,2565,Michael Porter Jr.,106,148,SF,1356,42,DEN,92,565
22,322,,45,245,.592,536,433,.576,752,103,.427,241,.540,993,180,.814,221,71,71,2223,Jalen Williams,37,175,PF,1355,80,OKC,123,282
29,219,CPOY-12,66,335,.561,450,396,.556,712,54,.388,139,.529,851,399,.883,452,39,39,1309,Joel Embiid,95,112,C,1353,46,PHI,150,430
28,189,AS,41,421,.575,479,343,.550,624,136,.416,327,.504,951,255,.873,292,62,62,2026,Karl-Anthony Towns,94,204,PF,1349,43,MIN,177,515
31,247,AS,26,219,.537,471,231,.503,459,240,.374,641,.428,1100,151,.921,164,79,33,2401,Bogdan BogdanoviÄ,53,179,SG,1333,96,ATL,112,272
26,363,6MOY-5,40,281,.534,500,414,.534,775,86,.355,242,.492,1017,246,.801,307,64,64,2103,Brandon Ingram,43,145,SF,1332,50,NOP,163,324
21,312,,46,406,.553,527,494,.567,871,33,.297,111,.537,982,244,.693,352,63,63,2046,Alperen Sengun,183,211,C,1331,76,HOU,162,589
23,277,,23,234,.550,498,332,.544,610,166,.372,446,.472,1056,161,.801,201,68,62,2248,Devin Vassell,27,74,SG,1323,73,SAS,108,261
32,305,,41,247,.572,484,245,.492,498,239,.429,557,.459,1055,115,.827,139,66,66,2159,CJ McCollum,39,126,PG,1322,62,NOP,110,286
27,100,,144,420,.587,476,360,.615,585,116,.358,324,.524,909,245,.773,317,77,77,2076,Myles Turner,113,232,C,1313,39,IND,109,533
25,450,,25,295,.568,457,303,.583,520,154,.367,420,.486,940,232,.853,272,82,57,2629,Austin Reaves,57,153,SG,1300,66,LAL,174,352
21,175,,42,255,.524,476,292,.495,590,184,.373,493,.440,1083,143,.827,173,74,68,2383,Brandon Miller,60,184,SF,1279,66,CHO,132,315
26,110,ROY-3,26,327,.578,427,252,.559,451,175,.399,439,.480,890,249,.899,277,55,55,1820,Lauri Markkanen,122,100,PF,1278,50,UTA,77,449
25,210,,81,568,.634,519,519,.638,813,0,.000,6,.634,819,233,.742,314,77,77,2442,Jarrett Allen,243,147,C,1271,53,CLE,121,811
29,589,DPOY-10,59,245,.527,423,196,.454,432,227,.387,586,.416,1018,197,.860,229,73,73,2684,Fred VanVleet,33,183,PG,1270,101,HOU,126,278
27,216,,36,234,.584,445,162,.542,299,283,.401,705,.443,1004,86,.754,114,81,63,2360,Donte DiVincenzo,63,166,SG,1259,107,NYK,113,297
26,384,,39,200,.554,474,329,.510,645,145,.425,341,.481,986,157,.853,184,59,59,1861,Jamal Murray,42,104,PG,1250,57,DEN,125,242
34,298,,17,213,.537,396,336,.519,648,60,.414,145,.499,793,394,.858,459,60,60,2042,Jimmy Butler,105,68,PF,1246,79,MIA,102,318
29,342,,21,212,.518,442,293,.498,588,149,.363,410,.443,998,172,.869,198,61,60,2040,Terry Rozier,35,101,SG,1205,63,2TM,106,247
29,198,,12,100,.535,252,169,.533,317,83,.358,232,.459,549,109,.845,129,30,30,1065,Terry Rozier,17,52,SG,696,32,CHO,65,117
29,144,,9,112,.497,190,124,.458,271,66,.371,178,.423,449,63,.913,69,31,30,975,Terry Rozier,18,49,PG,509,31,MIA,41,130
31,217,,46,373,.535,463,372,.537,693,91,.353,258,.487,951,187,.878,213,70,70,2368,Tobias Harris,80,115,PF,1204,70,PHI,93,453
34,614,,57,335,.541,352,166,.497,334,186,.381,488,.428,822,302,.878,344,72,72,2470,James Harden,34,127,PG,1192,77,LAC,185,369
22,363,,88,353,.528,447,346,.536,646,101,.341,296,.475,942,196,.781,251,60,60,2094,Scottie Barnes,141,118,SG,1191,75,TOR,165,494
21,163,AS,36,263,.560,456,403,.578,697,53,.321,165,.529,862,223,.746,299,74,46,1949,Jonathan Kuminga,92,169,PF,1188,55,GSW,122,355
21,296,,41,178,.492,417,293,.485,604,124,.336,369,.429,973,227,.749,303,77,61,2217,Jaden Ivey,86,204,SG,1185,57,DET,190,264
23,129,,59,314,.548,443,260,.560,464,183,.358,511,.454,975,103,.831,124,77,77,2588,Keegan Murray,106,205,SF,1172,79,SAC,64,420
23,193,,22,262,.547,436,346,.549,630,90,.360,250,.495,880,208,.715,291,58,58,1838,RJ Barrett,53,129,SG,1170,31,2TM,126,315
23,63,,9,92,.478,164,121,.469,258,43,.331,130,.423,388,103,.831,124,26,26,766,RJ Barrett,19,45,SG,474,12,NYK,47,111
23,130,,13,170,.601,272,225,.605,372,47,.392,120,.553,492,105,.629,167,32,32,1072,RJ Barrett,34,84,SG,696,19,TOR,79,204
24,331,,10,242,.530,388,217,.471,461,171,.395,433,.434,894,209,.853,245,68,38,1985,Immanuel Quickley,17,119,SG,1156,50,2TM,101,259
24,74,,3,72,.549,152,88,.509,173,64,.395,162,.454,335,82,.872,94,30,0,720,Immanuel Quickley,5,44,SG,450,16,NYK,31,77
24,257,,7,170,.518,236,129,.448,288,107,.395,271,.422,559,127,.841,151,38,38,1265,Immanuel Quickley,12,75,PG,706,34,TOR,70,182
28,115,,111,312,.589,388,278,.606,459,110,.375,293,.516,752,259,.858,302,57,57,1690,Kristaps PorziÅÄ£is,97,156,C,1145,42,BOS,89,409
31,139,,6,232,.510,392,181,.478,379,211,.353,597,.402,976,144,.852,169,79,12,2120,Tim Hardaway Jr.,22,106,SF,1139,42,DAL,69,254
29,152,6MOY-9,34,154,.516,383,272,.474,574,111,.402,276,.451,850,255,.817,312,54,54,1830,Jerami Grant,37,117,PF,1132,45,POR,116,191
28,104,,34,465,.562,466,366,.545,672,100,.407,246,.508,918,98,.790,124,82,4,2008,Bobby Portis,142,189,PF,1130,68,MIL,91,607
30,488,6MOY-3,17,203,.509,403,265,.474,559,138,.375,368,.435,927,178,.836,213,80,58,2486,Dennis SchrÃ¶der,39,164,PG,1122,63,2TM,153,242
30,313,,8,118,.511,247,170,.501,339,77,.350,220,.442,559,127,.852,149,51,33,1559,Dennis SchrÃ¶der,22,105,PG,698,46,TOR,83,140
30,175,,9,85,.507,156,95,.432,220,61,.412,148,.424,368,51,.797,64,29,25,927,Dennis SchrÃ¶der,17,59,PG,424,17,BRK,70,102
25,370,,39,184,.526,396,248,.528,470,148,.350,423,.443,893,170,.829,205,72,0,1872,Malik Monk,28,156,SG,1110,45,SAC,150,212
29,377,"CPOY-12,6MOY-2",87,259,.578,387,191,.555,344,196,.396,495,.461,839,137,.901,152,73,73,2381,Derrick White,51,152,SG,1107,74,BOS,112,310
23,286,DPOY-8,36,456,.560,406,318,.560,568,88,.374,235,.506,803,202,.740,273,75,75,2257,Deni Avdija,84,185,SF,1102,60,WAS,160,540
29,229,,12,324,.518,395,319,.539,592,76,.311,244,.472,836,236,.781,302,46,46,1630,Julius Randle,99,125,PF,1102,25,NYK,159,423
24,106,AS,73,350,.576,406,237,.535,443,169,.414,408,.477,851,109,.736,148,81,14,1964,Naz Reid,73,172,C,1090,63,MIN,111,423
24,195,6MOY-1,20,282,.527,391,264,.533,495,127,.346,367,.454,862,175,.792,221,69,27,2038,Keldon Johnson,95,149,SF,1084,51,SAS,100,377
24,156,,16,195,.602,386,202,.643,314,184,.383,480,.486,794,114,.726,157,80,22,2067,Corey Kispert,30,141,SF,1070,41,WAS,98,225
31,102,,162,697,.661,406,406,.664,611,0,.000,3,.661,614,249,.638,390,76,76,2593,Rudy Gobert,285,238,C,1061,52,MIN,118,982
30,82,DPOY-1,22,179,.594,373,206,.536,384,167,.435,384,.486,768,143,.831,172,76,3,1990,Norman Powell,16,137,SG,1056,43,LAC,66,195
28,101,6MOY-4,47,247,.498,387,286,.517,553,101,.311,325,.441,878,174,.750,232,68,52,2055,Kelly Oubre Jr.,94,194,SF,1049,77,PHI,87,341
20,121,,61,477,.537,378,240,.530,453,138,.363,380,.454,833,150,.811,185,76,76,2424,Jabari Smith Jr.,139,200,PF,1044,52,HOU,89,616
24,255,,5,145,.523,360,204,.472,432,156,.385,405,.430,837,163,.916,178,46,46,1582,Anfernee Simons,22,98,SG,1039,23,POR,126,167
24,373,,7,122,.524,375,243,.501,485,132,.371,356,.446,841,146,.834,175,57,57,1901,Darius Garland,30,95,PG,1028,74,CLE,176,152
26,77,,61,418,.590,397,311,.605,514,86,.371,232,.532,746,147,.795,185,68,66,1901,John Collins,157,191,PF,1027,40,UTA,98,575
28,227,,45,247,.649,340,135,.570,237,205,.461,445,.499,682,129,.878,147,75,74,2513,Grayson Allen,48,157,SG,1014,69,PHO,95,295
28,259,,45,297,.584,398,358,.619,578,40,.290,138,.556,716,177,.658,269,73,73,2297,Aaron Gordon,174,142,PF,1013,56,DEN,105,471
31,236,,42,208,.565,371,152,.539,282,219,.386,568,.436,850,52,.881,59,84,42,2160,Buddy Hield,61,169,SF,1013,70,2TM,103,269
31,139,,31,133,.575,229,92,.575,160,137,.384,357,.443,517,28,.848,33,52,28,1336,Buddy Hield,34,103,SF,623,43,IND,62,167
31,97,,11,75,.550,142,60,.492,122,82,.389,211,.426,333,24,.923,26,32,14,824,Buddy Hield,27,66,SG,390,27,PHI,41,102
31,173,,68,535,.585,402,365,.609,599,37,.308,120,.559,719,161,.785,205,82,82,1925,Jonas ValanÄiÅ«nas,186,218,C,1002,32,NOP,111,721
31,99,,12,182,.576,347,198,.571,347,149,.387,385,.474,732,157,.801,196,82,82,2381,Harrison Barnes,67,98,PF,1000,54,SAC,58,249
25,230,,22,149,.552,360,223,.536,416,137,.381,360,.464,776,140,.870,161,42,42,1443,Desmond Bane,36,120,SG,997,43,MEM,112,185
35,127,,189,292,.583,366,218,.621,351,148,.366,404,.485,755,110,.821,134,79,79,2411,Brook Lopez,117,191,C,990,43,MIL,79,409
21,386,,44,403,.523,402,320,.530,604,82,.337,243,.475,847,100,.806,124,80,80,2011,Josh Giddey,111,111,SG,986,51,OKC,168,514
20,332,,7,196,.482,319,172,.459,375,147,.334,440,.391,815,189,.848,223,75,44,2023,Keyonte George,15,91,PG,974,36,UTA,188,211
25,119,,10,163,.531,361,183,.464,394,178,.393,453,.426,847,74,.771,96,71,41,1994,Gary Trent Jr.,25,96,SG,974,77,TOR,47,188
30,265,,27,178,.582,377,276,.552,500,101,.430,235,.513,735,109,.813,134,53,53,1767,Bradley Beal,54,127,SG,964,52,PHO,131,232
29,346,,34,241,.487,345,237,.486,488,108,.325,332,.421,820,154,.766,201,68,10,1958,Caris LeVert,39,121,SG,952,76,CLE,117,280
22,205,,47,181,.578,336,183,.556,329,153,.397,385,.471,714,118,.756,156,75,75,2025,Jalen Suggs,48,205,SG,943,106,ORL,132,229
31,277,DPOY-10,6,139,.469,337,246,.485,507,91,.294,309,.413,816,177,.881,201,55,19,1682,Jordan Clarkson,49,81,SG,942,35,UTA,146,188
28,119,,41,213,.511,353,262,.498,526,91,.358,254,.453,780,142,.751,189,71,59,1920,Andrew Wiggins,108,147,SF,939,42,GSW,87,321
25,141,,59,326,.518,354,222,.558,398,132,.320,413,.436,811,99,.683,145,73,45,2221,P.J. Washington,85,169,PF,939,72,2TM,96,411
25,97,,32,179,.524,227,148,.558,265,79,.324,244,.446,509,67,.713,94,44,17,1286,P.J. Washington,53,112,PF,600,38,CHO,66,232
25,44,,27,147,.508,127,74,.556,133,53,.314,169,.421,302,32,.627,51,29,28,935,P.J. Washington,32,57,PF,339,34,DAL,30,179
23,236,,37,247,.496,332,239,.490,488,93,.338,275,.435,763,180,.826,218,81,0,1817,Cole Anthony,64,175,PG,937,64,ORL,126,311
24,242,,36,162,.583,360,241,.568,424,119,.403,295,.501,719,85,.810,105,76,37,2212,Ayo Dosunmu,54,166,SG,924,68,CHI,103,216
25,81,,25,236,.609,363,265,.597,444,98,.422,232,.537,676,99,.739,134,68,39,1826,Rui Hachimura,58,101,PF,923,41,LAL,46,294
25,90,,42,433,.571,427,426,.576,739,1,.100,10,.570,749,65,.823,79,55,55,1784,Deandre Ayton,176,109,C,920,56,POR,99,609
28,119,,10,193,.515,329,196,.492,398,133,.359,370,.428,768,124,.844,147,72,72,2227,Dillon Brooks,53,241,SF,915,64,HOU,88,246
22,203,,47,414,.562,359,288,.574,502,71,.355,200,.511,702,107,.728,147,56,52,1889,Jalen Johnson,74,133,SF,896,67,ATL,101,488
26,87,,16,191,.547,304,187,.521,359,117,.385,304,.459,663,166,.847,196,57,37,1681,De'Andre Hunter,31,146,SF,891,40,ATL,83,222
27,108,,9,249,.598,320,96,.533,180,224,.413,542,.443,722,25,.714,35,79,77,2337,Malik Beasley,41,158,SG,889,59,MIL,54,290
22,195,,20,203,.536,341,276,.558,495,65,.322,202,.489,697,142,.811,175,75,20,2113,Jaime Jaquez Jr.,82,167,SF,889,77,MIA,110,285
24,108,"ROY-4,6MOY-9",49,212,.606,315,175,.581,301,140,.419,334,.496,635,107,.781,137,72,47,1995,Aaron Nesmith,63,241,SF,877,65,IND,64,275
24,188,,3,203,.531,324,192,.478,402,132,.396,333,.441,735,95,.856,111,42,40,1407,Tyler Herro,19,63,SG,875,30,MIA,93,222
29,192,,16,158,.589,304,117,.579,202,187,.395,473,.450,675,80,.889,90,68,36,1905,Duncan Robinson,15,163,SF,875,46,MIA,95,173
36,449,,17,181,.595,294,115,.481,239,179,.442,405,.457,644,102,.911,112,76,76,2193,Mike Conley,37,128,PG,869,88,MIN,102,218
19,336,,13,141,.440,307,220,.416,529,87,.325,268,.385,797,167,.819,204,62,32,1765,Scoot Henderson,53,195,PG,868,48,POR,212,194
26,96,,21,230,.636,332,294,.673,437,38,.330,115,.601,552,166,.814,204,80,1,1415,Moritz Wagner,117,160,C,868,39,ORL,97,347
34,97,,5,130,.551,309,176,.507,347,133,.398,334,.454,681,117,.785,149,57,27,1478,Bojan BogdanoviÄ,22,95,PF,868,30,2TM,101,152
34,71,6MOY-9,4,81,.569,199,113,.518,218,86,.415,207,.468,425,81,.779,104,28,27,921,Bojan BogdanoviÄ,13,57,PF,565,23,DET,63,94
34,26,,1,49,.521,110,63,.488,129,47,.370,127,.430,256,36,.800,45,29,0,557,Bojan BogdanoviÄ,9,38,SF,303,7,NYK,38,58
24,92,,11,244,.497,290,177,.522,339,113,.316,358,.416,697,170,.837,203,63,51,2062,Saddiq Bey,167,88,SF,863,51,ATL,54,411
20,249,,40,339,.483,340,270,.492,549,70,.308,227,.438,776,111,.771,144,74,73,2193,Jeremy Sochan,137,168,PF,861,62,SAS,140,476
24,113,,47,210,.557,288,132,.506,261,156,.394,396,.438,657,128,.826,155,79,79,2246,Luguentz Dort,74,228,SF,860,72,OKC,74,284
33,333,,53,289,.581,331,193,.526,367,138,.429,322,.480,689,60,.833,72,69,69,2263,Jrue Holiday,84,108,PG,860,61,BOS,124,373
21,119,DPOY-6,14,174,.507,296,216,.481,449,80,.374,214,.446,663,184,.821,224,59,19,1538,Bennedict Mathurin,60,117,SF,856,35,IND,97,234
27,283,,29,272,.533,304,136,.546,249,168,.351,479,.418,728,77,.794,97,70,70,2239,Max Strus,66,170,SF,853,64,CLE,112,338
25,128,,43,235,.661,332,230,.706,326,102,.403,253,.573,579,77,.770,100,82,28,1730,Obi Toppin,85,143,PF,843,47,IND,69,320
23,124,,28,238,.579,275,106,.602,176,169,.380,445,.443,621,123,.815,151,57,23,1690,Trey Murphy III,42,70,SF,842,51,NOP,34,280
24,147,,146,513,.630,366,365,.633,577,1,.200,5,.629,582,108,.551,196,71,71,2116,Nic Claxton,193,175,C,841,46,BRK,93,706
20,147,,47,517,.619,349,349,.623,560,0,.000,4,.619,564,143,.790,181,61,60,1777,Jalen Duren,192,192,C,841,33,DET,129,709
25,199,,62,198,.595,293,179,.568,315,114,.418,273,.498,588,137,.867,158,76,76,2321,Herbert Jones,74,224,SF,837,105,NOP,93,272
29,91,DPOY-5,106,441,.571,353,353,.572,617,0,.000,1,.571,618,130,.631,206,73,73,1883,Clint Capela,335,164,C,836,43,ATL,74,776
33,308,,13,122,.499,326,224,.475,472,102,.359,284,.431,756,79,.806,98,82,23,1817,Reggie Jackson,33,149,PG,833,44,DEN,106,155
29,301,,80,613,.528,320,298,.555,537,22,.244,90,.510,627,167,.640,261,76,76,2078,Jusuf NurkiÄ,224,254,C,829,81,PHO,175,837
32,292,,15,217,.566,317,223,.563,396,94,.381,247,.493,643,100,.833,120,55,55,1487,Khris Middleton,40,141,SF,828,51,MIL,127,257
25,115,,153,367,.725,348,348,.725,480,0,,0,.725,480,118,.674,175,74,66,1815,Daniel Gafford,195,227,PF,814,65,2TM,74,562
25,69,,97,230,.690,203,203,.690,294,0,,0,.690,294,84,.706,119,45,45,1192,Daniel Gafford,131,147,C,490,44,WAS,46,361
25,46,,56,137,.780,145,145,.780,186,0,,0,.780,186,34,.607,56,29,21,623,Daniel Gafford,64,80,PF,324,21,DAL,28,201
30,356,,22,175,.489,251,127,.467,272,124,.337,368,.392,640,169,.805,210,76,52,2152,Spencer Dinwiddie,30,138,PG,795,51,2TM,91,205
30,288,,9,132,.480,195,106,.480,221,89,.320,278,.391,499,125,.781,160,48,48,1474,Spencer Dinwiddie,26,86,PG,604,38,BRK,62,158
30,68,,13,43,.521,56,21,.412,51,35,.389,90,.397,141,44,.880,50,28,4,678,Spencer Dinwiddie,4,52,PG,191,13,LAL,29,47
26,93,,83,430,.649,337,337,.649,519,0,,0,.649,519,120,.723,166,68,68,1794,Ivica Zubac,196,180,C,794,22,LAC,79,626
27,485,,18,159,.569,326,220,.537,410,106,.414,256,.489,666,32,.800,40,66,66,1933,Tyus Jones,20,48,PG,790,71,WAS,66,179
26,281,,6,195,.583,297,150,.593,253,147,.385,382,.468,635,46,.821,56,82,5,1825,Payton Pritchard,70,106,PG,787,39,BOS,61,265
22,160,,72,357,.600,320,298,.604,493,22,.373,59,.580,552,123,.719,171,50,50,1532,Evan Mobley,111,134,PF,785,45,CLE,90,468
25,174,,39,232,.560,276,150,.558,269,126,.375,336,.456,605,106,.757,140,76,43,2130,Grant Williams,86,226,PF,784,44,2TM,109,318
25,81,,27,123,.538,131,52,.486,107,79,.376,210,.413,317,41,.745,55,47,33,1242,Grant Williams,46,137,PF,382,24,DAL,53,169
25,93,,12,109,.585,145,98,.605,162,47,.373,126,.503,288,65,.765,85,29,10,888,Grant Williams,40,89,PF,402,20,CHO,56,149
26,194,,52,252,.531,298,240,.552,435,58,.320,181,.484,616,122,.753,162,69,29,1526,Zach Collins,118,206,C,776,34,SAS,132,370
27,138,,15,196,.557,276,138,.519,266,138,.391,353,.446,619,86,.789,109,58,47,1599,Cameron Johnson,55,105,PF,776,49,BRK,57,251
24,478,,9,231,.558,303,239,.584,409,64,.335,191,.505,600,101,.856,118,77,48,2138,Tre Jones,58,92,PG,771,78,SAS,116,289
30,98,,18,256,.567,284,135,.572,236,149,.376,396,.449,632,51,.850,60,82,10,1831,Georges Niang,22,192,PF,768,30,CLE,72,278
30,183,,42,152,.566,270,145,.520,279,125,.406,308,.460,587,101,.894,113,76,76,2402,Kentavious Caldwell-Pope,31,151,SG,766,98,DEN,75,183
32,347,,30,303,.616,276,216,.632,342,60,.387,155,.555,497,150,.833,180,78,27,1759,Kelly Olynyk,108,230,C,762,74,2TM,152,411
32,219,,12,191,.632,145,109,.626,174,36,.429,84,.562,258,80,.842,95,50,8,1019,Kelly Olynyk,63,132,C,406,37,UTA,81,254
32,128,,18,112,.598,131,107,.637,168,24,.338,71,.548,239,70,.824,85,28,19,740,Kelly Olynyk,45,98,C,356,37,TOR,71,157
28,331,,23,547,.493,295,215,.511,421,80,.310,258,.434,679,91,.791,115,81,42,2707,Josh Hart,128,171,SF,761,75,NYK,118,675
23,101,,42,168,.557,307,221,.592,373,86,.337,255,.489,628,57,.722,79,72,71,2105,Jaden McDaniels,56,219,SF,757,63,MIN,87,224
35,306,,23,250,.486,301,259,.509,509,42,.273,154,.454,663,110,.688,160,68,11,1529,Russell Westbrook,93,121,PG,754,74,LAC,144,343
35,139,6MOY-7,30,106,.565,274,124,.561,221,150,.378,397,.443,618,51,.797,64,68,24,1893,Eric Gordon,16,79,SG,749,66,PHO,73,122
26,107,,36,161,.577,282,180,.581,310,102,.382,267,.489,577,67,.753,89,50,50,1702,OG Anunoby,47,119,SF,733,68,2TM,81,208
26,72,,13,82,.584,157,96,.608,158,61,.374,163,.489,321,33,.717,46,27,27,900,OG Anunoby,24,62,SF,408,28,TOR,43,106
26,35,,23,79,.568,125,84,.553,152,41,.394,104,.488,256,34,.791,43,23,23,802,OG Anunoby,23,57,SF,325,40,NYK,38,102
31,390,,8,155,.572,330,312,.568,549,18,.409,44,.556,593,49,.790,62,71,4,1291,T.J. McConnell,36,79,PG,727,72,IND,108,191
27,192,6MOY-7,17,231,.523,278,225,.538,418,53,.323,164,.478,582,117,.824,142,67,44,1866,Bruce Brown,53,148,SG,726,59,2TM,86,284
27,100,,8,129,.527,149,116,.545,213,33,.327,101,.475,314,67,.817,82,33,33,981,Bruce Brown,25,81,SG,398,35,IND,41,154
27,92,,9,102,.519,129,109,.532,205,20,.317,63,.481,268,50,.833,60,34,11,885,Bruce Brown,28,67,PG,328,24,TOR,45,130
29,247,,70,211,.593,253,117,.563,208,136,.408,333,.468,541,73,.760,96,71,57,2040,Alex Caruso,62,181,SG,715,120,CHI,102,273
26,82,DPOY-10,25,231,.623,249,52,.559,93,197,.424,465,.446,558,17,.895,19,79,13,1741,Sam Hauser,45,99,SF,712,40,BOS,32,276
19,59,,24,143,.519,241,139,.502,277,102,.357,286,.428,563,115,.752,153,48,18,1233,GG Jackson II,53,64,PF,699,28,MEM,65,196
29,119,,35,209,.566,253,112,.519,216,141,.396,356,.442,572,50,.735,68,78,49,2108,Taurean Prince,21,146,PF,697,58,LAL,73,230
28,101,,23,182,.582,252,118,.551,214,134,.401,334,.460,548,54,.818,66,66,43,1644,Simone Fontecchio,64,110,SF,692,44,2TM,68,246
28,73,,18,124,.577,161,70,.560,125,91,.391,233,.450,358,32,.800,40,50,34,1160,Simone Fontecchio,52,81,SF,445,30,UTA,51,176
28,28,,5,58,.592,91,48,.539,89,43,.426,101,.479,190,22,.846,26,16,9,484,Simone Fontecchio,12,29,SF,247,14,DET,17,70
20,156,,8,120,.506,271,178,.494,360,93,.347,268,.432,628,55,.873,63,75,29,1594,Malaki Branham,28,94,PG,690,27,SAS,91,148
32,88,,12,126,.478,210,86,.360,239,124,.376,330,.369,569,145,.868,167,66,1,1212,Alec Burks,24,75,SG,689,28,2TM,48,150
32,68,,11,94,.516,160,61,.384,159,99,.401,247,.394,406,121,.903,134,43,0,901,Alec Burks,16,64,SG,540,21,DET,32,110
32,20,,1,32,.383,50,25,.313,80,25,.301,83,.307,163,24,.727,33,23,1,311,Alec Burks,8,11,SG,149,7,NYK,16,40
20,273,,14,309,.529,271,181,.499,363,90,.385,234,.454,597,50,.633,79,74,28,1968,Brandin Podziemski,118,122,SG,682,61,GSW,88,427
30,37,ROY-5,48,443,.556,267,267,.560,477,0,.000,3,.556,480,129,.592,218,79,10,1351,Andre Drummond,265,140,C,663,73,CHI,81,708
27,119,,15,167,.587,254,183,.633,289,71,.348,204,.515,493,79,.832,95,75,71,1873,Terance Mann,87,145,SG,658,43,LAC,48,254
26,75,,51,168,.566,239,157,.613,256,82,.343,239,.483,495,97,.713,136,76,66,1783,Derrick Jones Jr.,82,121,SF,657,53,DAL,65,250
25,204,,42,132,.560,236,105,.517,203,131,.391,335,.439,538,52,.800,65,82,20,1921,Nickeil Alexander-Walker,35,143,SG,655,64,MIN,76,167
25,166,,23,186,.553,248,125,.571,219,123,.361,341,.443,560,36,.766,47,64,59,1562,Kevin Huerter,38,135,SG,655,45,SAC,53,224
23,138,,54,280,.528,247,141,.534,264,106,.349,304,.435,568,54,.621,87,61,35,1618,Santi Aldama,72,89,PF,654,43,MEM,69,352
26,54,,74,367,.691,260,260,.693,375,0,.000,1,.691,376,132,.737,179,67,51,1759,Nick Richards,172,176,C,652,26,CHO,73,539
23,132,,34,139,.577,235,151,.570,265,84,.391,215,.490,480,93,.679,137,69,42,1887,Isaac Okoro,67,140,SF,647,57,CLE,54,206
28,143,,29,207,.504,241,160,.489,327,81,.349,232,.431,559,77,.778,99,64,23,1756,Caleb Martin,74,126,SF,640,47,MIA,77,281
21,71,,22,357,.500,234,193,.522,370,41,.295,139,.460,509,129,.754,171,72,23,1700,Jabari Walker,151,173,SF,638,42,POR,66,508
24,99,,22,148,.609,222,75,.568,132,147,.416,353,.458,485,45,.865,52,78,1,1445,Isaiah Joe,32,87,SG,636,46,OKC,47,180
24,280,,6,105,.557,260,199,.567,351,61,.357,171,.498,522,45,.804,56,68,47,1697,Andrew Nembhard,36,143,PG,626,63,IND,101,141
27,67,,38,157,.549,230,142,.559,254,88,.359,245,.461,499,69,.742,93,68,20,1214,Duop Reath,93,161,C,617,33,POR,52,250
31,214,,8,120,.522,218,136,.458,297,82,.412,199,.440,496,95,.819,116,39,25,1121,Malcolm Brogdon,28,58,PG,613,27,POR,60,148
30,219,,44,317,.542,214,58,.496,117,156,.370,422,.397,539,24,.686,35,79,14,1954,Royce O'Neale,60,174,SF,608,59,2TM,73,377
30,137,,29,183,.537,126,29,.483,60,97,.366,265,.388,325,15,.682,22,49,6,1202,Royce O'Neale,38,120,SF,364,32,BRK,51,221
30,82,,15,134,.549,88,29,.509,57,59,.376,157,.411,214,9,.692,13,30,8,752,Royce O'Neale,22,54,SF,244,27,PHO,22,156
24,95,,28,269,.600,223,159,.626,254,64,.374,171,.525,425,93,.694,134,55,48,1406,Wendell Carter Jr.,112,121,C,603,35,ORL,68,381
23,63,,38,225,.670,234,173,.689,251,61,.424,144,.592,395,72,.692,104,61,14,1047,Jalen Smith,112,124,C,601,17,IND,44,337
22,132,,35,227,.525,222,159,.498,319,63,.384,164,.460,483,93,.694,134,82,4,1655,Christian Braun,79,137,SG,600,42,DEN,55,306
24,109,,84,295,.561,259,238,.563,423,21,.368,57,.540,480,61,.718,85,82,24,1590,Paul Reed,193,198,C,600,67,PHI,67,488
21,163,,38,261,.545,239,231,.595,388,8,.138,58,.536,446,106,.684,155,62,23,1388,Amen Thompson,148,141,SF,592,78,HOU,90,409
23,236,,12,114,.516,219,129,.474,272,90,.375,240,.428,512,58,.879,66,71,11,1351,Marcus Sasser,11,103,PG,586,44,DET,90,125
24,55,,33,182,.597,239,230,.597,385,9,.391,23,.586,408,96,.762,126,50,25,1053,Marvin Bagley III,130,81,C,583,20,2TM,59,312
24,27,,14,72,.594,107,106,.606,175,1,.167,6,.591,181,50,.820,61,26,10,478,Marvin Bagley III,46,40,C,265,5,DET,29,118
24,28,,19,110,.599,132,124,.590,210,8,.471,17,.581,227,46,.708,65,24,15,575,Marvin Bagley III,84,41,C,318,15,WAS,30,194
25,188,,85,382,.645,235,234,.646,362,1,.333,3,.644,365,111,.707,157,75,49,1896,Isaiah Hartenstein,244,210,C,582,87,NYK,93,626
30,107,,38,208,.535,215,98,.560,175,117,.348,336,.421,511,33,.717,46,68,56,1934,Dorian Finney-Smith,109,150,PF,580,56,BRK,59,317
19,33,,17,136,.539,212,133,.538,247,79,.359,220,.454,467,76,.679,112,47,2,880,Cam Whitmore,44,64,SF,579,30,HOU,46,180
29,205,,11,96,.541,208,104,.486,214,104,.390,267,.432,481,58,.866,67,78,10,1304,Cameron Payne,21,126,PG,578,42,2TM,66,117
29,109,,3,57,.572,101,49,.538,91,52,.397,131,.455,222,37,.841,44,47,2,702,Cameron Payne,5,73,PG,291,22,MIL,31,62
29,96,,8,39,.514,107,55,.447,123,52,.382,136,.413,259,21,.913,23,31,8,602,Cameron Payne,16,53,PG,287,20,PHI,35,55
25,74,,20,114,.528,208,104,.471,221,104,.384,271,.423,492,45,.763,59,58,0,1011,Lonnie Walker IV,13,71,SG,565,32,BRK,51,127
24,97,,68,296,.529,235,209,.562,372,26,.268,97,.501,469,69,.616,112,74,18,1624,Precious Achiuwa,191,143,PF,565,46,2TM,83,487
24,44,,12,86,.497,78,65,.528,123,13,.277,47,.459,170,24,.571,42,25,0,437,Precious Achiuwa,50,40,C,193,16,TOR,29,136
24,53,,56,210,.547,157,144,.578,249,13,.260,50,.525,299,45,.643,70,49,18,1187,Precious Achiuwa,141,103,PF,372,30,NYK,54,351
37,168,,62,331,.640,214,106,.658,161,108,.419,258,.511,419,26,.867,30,65,33,1740,Al Horford,82,93,C,562,38,BOS,48,413
23,114,,7,69,.572,205,96,.511,188,109,.410,266,.452,454,43,.860,50,68,14,1328,Miles McBride,31,108,PG,562,50,NYK,30,100
23,74,,60,231,.642,223,200,.676,296,23,.333,69,.611,365,92,.793,116,55,8,1405,Onyeka Okongwu,145,162,C,561,26,ATL,45,376
20,120,,37,135,.602,217,119,.572,208,98,.419,234,.491,442,29,.784,37,82,13,1692,Cason Wallace,52,129,SG,561,76,OKC,45,187
24,127,,20,137,.463,202,143,.475,301,59,.296,199,.404,500,94,.783,120,54,9,1047,Dalano Banton,41,64,PG,557,33,2TM,77,178
24,19,,3,23,.392,19,17,.486,35,2,.125,16,.373,51,16,.800,20,24,1,171,Dalano Banton,12,20,PG,56,5,BOS,10,35
24,108,,17,114,.471,183,126,.474,266,57,.311,183,.408,449,78,.780,100,30,8,876,Dalano Banton,29,44,PG,501,28,POR,67,143
21,120,,59,273,.505,232,211,.575,367,21,.186,113,.483,480,71,.597,119,63,38,1583,Ausar Thompson,129,175,SF,556,68,DET,84,402
28,127,,76,283,.656,248,248,.656,378,0,,0,.656,378,59,.551,107,50,50,1319,Jakob Poeltl,146,149,C,555,35,TOR,77,429
25,86,,19,126,.645,212,150,.598,251,62,.492,126,.562,377,56,.789,71,78,4,1228,Aaron Wiggins,60,91,SG,542,56,OKC,56,186
23,82,,76,206,.702,233,233,.704,331,0,.000,1,.702,332,74,.561,132,68,16,1130,Trayce Jackson-Davis,135,108,PF,540,29,GSW,49,341
21,57,,24,131,.548,194,122,.555,220,72,.360,200,.462,420,73,.785,93,66,9,1156,Moses Moody,65,90,SG,533,42,GSW,44,196
38,393,,6,207,.525,206,128,.498,257,78,.371,210,.441,467,43,.827,52,58,18,1531,Chris Paul,18,108,PG,533,70,GSW,76,225
19,110,,48,200,.509,188,124,.502,247,64,.346,185,.435,432,92,.702,131,63,15,1715,Bilal Coulibaly,56,137,SF,532,57,WAS,87,256
21,86,,88,202,.516,208,163,.553,295,45,.296,152,.465,447,71,.670,106,80,4,1488,Peyton Watson,56,143,SF,532,42,DEN,58,258
21,109,,4,111,.492,195,114,.447,255,81,.362,224,.407,479,59,.776,76,73,7,989,Jaden Hardy,20,80,SG,530,22,DAL,62,131
23,87,,33,204,.516,197,139,.523,266,58,.337,172,.450,438,75,.758,99,70,49,1739,Toumani Camara,139,174,PF,527,66,POR,84,343
22,176,,4,84,.515,183,113,.500,226,70,.355,197,.433,423,90,.865,104,22,22,711,LaMelo Ball,29,79,PG,526,40,CHO,83,113
21,70,,7,119,.501,174,65,.411,158,109,.366,298,.382,456,67,.838,80,67,10,1160,Jordan Hawkins,29,72,SG,524,19,NOP,40,148
23,175,,34,231,.550,169,90,.529,170,79,.378,209,.446,379,104,.800,130,52,33,1436,Vince Williams Jr.,59,135,SG,521,47,MEM,92,290
22,60,,154,316,.660,229,225,.680,331,4,.211,19,.654,350,56,.602,93,64,22,1493,Walker Kessler,165,132,C,518,30,UTA,66,481
23,177,,19,100,.460,184,124,.438,283,60,.330,182,.396,465,88,.807,109,51,11,1009,Talen Horton-Tucker,21,94,PG,516,45,UTA,65,121
29,144,,10,210,.562,181,107,.560,191,74,.376,197,.466,388,79,.849,93,64,9,1098,Dario Å ariÄ,73,112,C,515,31,GSW,78,283
27,140,,6,100,.547,186,102,.510,200,84,.387,217,.446,417,58,.921,63,78,1,1269,Aaron Holiday,23,125,PG,514,42,HOU,53,123
20,68,,2,105,.524,189,101,.495,204,88,.365,241,.425,445,44,.863,51,60,17,1268,Gradey Dick,27,87,SG,510,34,TOR,50,132
20,94,,12,118,.475,176,116,.457,254,60,.333,180,.406,434,98,.824,119,32,25,1059,Shaedon Sharpe,42,88,SG,510,28,POR,72,160
37,70,,31,132,.529,167,114,.553,206,53,.331,160,.456,366,122,.819,149,78,6,1307,Jeff Green,46,100,PF,509,16,HOU,46,178
30,331,,47,213,.472,199,188,.488,385,11,.229,48,.460,433,97,.708,137,79,10,1782,Kyle Anderson,60,128,PF,506,71,MIN,91,273
22,103,,42,164,.534,164,63,.504,125,101,.365,277,.408,402,75,.815,92,74,59,1468,Julian Champagnie,42,77,SF,504,48,SAS,57,206
22,73,,38,231,.575,186,119,.575,207,67,.383,175,.487,382,64,.753,85,46,45,1423,Isaiah Stewart,74,99,PF,503,17,DET,66,305
33,158,,13,143,.510,187,150,.479,313,37,.411,90,.464,403,89,.742,120,51,28,1245,Gordon Hayward,38,67,SF,500,40,2TM,66,181
33,116,,12,92,.505,139,117,.496,236,22,.361,61,.468,297,62,.765,81,25,25,798,Gordon Hayward,25,46,SF,362,28,CHO,51,117
33,42,,1,51,.524,48,33,.429,77,15,.517,29,.453,106,27,.692,39,26,3,447,Gordon Hayward,13,21,SF,138,12,OKC,15,64
28,119,,11,155,.591,184,98,.601,163,86,.389,221,.479,384,35,.673,52,72,3,1269,Cedi Osman,25,107,SF,489,36,SAS,47,180
28,98,,8,121,.531,170,111,.536,207,59,.349,169,.452,376,88,.854,103,25,23,872,Zach LaVine,8,57,SG,487,21,CHI,52,129
37,253,,21,160,.562,163,65,.512,127,98,.392,250,.432,377,63,.840,75,60,55,1690,Kyle Lowry,34,146,PG,487,59,2TM,85,194
37,147,,15,104,.554,103,41,.506,81,62,.385,161,.426,242,35,.833,42,37,35,1037,Kyle Lowry,25,94,PG,303,39,MIA,53,129
37,106,,6,56,.578,60,24,.522,46,36,.404,89,.444,135,28,.848,33,23,20,653,Kyle Lowry,9,52,PG,184,20,PHI,32,65
35,115,,10,279,.557,158,74,.643,115,84,.344,244,.440,359,85,.787,108,55,5,924,Kevin Love,59,97,PF,485,18,MIA,48,338
27,108,,4,98,.584,158,15,.385,39,143,.404,354,.402,393,26,.929,28,61,1,1069,Sam Merrill,22,72,SG,485,19,CLE,19,120
19,60,,77,243,.747,221,221,.752,294,0,.000,2,.747,296,41,.506,81,55,42,1294,Dereck Lively II,135,144,C,483,36,DAL,50,378
33,332,ROY-6,47,322,.566,185,134,.551,243,51,.395,129,.497,372,54,.730,74,55,52,1490,Draymond Green,76,166,PF,475,55,GSW,135,398
23,130,,9,144,.575,179,107,.572,187,72,.385,187,.479,374,39,.684,57,57,33,1505,Josh Green,40,107,SG,469,47,DAL,60,184
26,128,,12,187,.542,170,112,.516,217,58,.387,150,.463,367,68,.791,86,66,1,1257,Naji Marshall,53,91,SF,466,49,NOP,65,240
26,76,,14,119,.571,166,96,.571,168,70,.380,184,.472,352,61,.859,71,70,13,1460,Amir Coffey,29,102,SF,463,41,LAC,33,148
23,83,,44,142,.483,178,116,.523,222,62,.294,211,.411,433,37,.661,56,78,28,1641,Ochai Agbaji,74,117,SG,455,47,2TM,64,216
23,47,,29,91,.520,106,59,.551,107,47,.331,142,.426,249,15,.750,20,51,10,1003,Ochai Agbaji,35,66,SG,274,27,UTA,34,126
23,36,,15,51,.432,72,57,.496,115,15,.217,69,.391,184,22,.611,36,27,18,638,Ochai Agbaji,39,51,SG,181,20,TOR,30,90
35,212,,31,190,.497,158,97,.490,198,61,.337,181,.417,379,74,.822,90,73,13,1462,Patrick Beverley,49,128,PG,451,43,2TM,65,239
35,144,,18,115,.504,104,69,.523,132,35,.321,109,.432,241,51,.810,63,47,5,919,Patrick Beverley,30,83,PG,294,24,PHI,49,145
35,68,,13,75,.486,54,28,.424,66,26,.361,72,.391,138,23,.852,27,26,8,543,Patrick Beverley,19,45,PG,157,19,MIL,16,94
22,54,,39,226,.613,187,187,.617,303,0,.000,2,.613,305,72,.706,102,63,6,1091,James Wiseman,110,141,C,446,12,DET,66,336
23,81,,19,142,.571,164,137,.564,243,27,.397,68,.527,311,77,.794,97,63,2,856,Trendon Watford,52,106,PF,432,23,BRK,63,194
27,136,,2,102,.617,141,34,.442,77,107,.450,238,.448,315,40,.889,45,39,22,999,Luke Kennard,11,39,SG,429,20,MEM,54,113
22,66,,33,120,.525,159,100,.474,211,59,.399,148,.443,359,52,.788,66,43,30,1174,Patrick Williams,46,87,PF,429,40,CHI,57,166
31,161,,19,188,.553,151,69,.633,109,82,.345,238,.435,347,44,.759,58,76,3,1676,Pat Connaughton,51,99,SF,428,40,MIL,49,239
28,157,,5,124,.621,161,108,.557,194,53,.491,108,.533,302,53,.779,68,55,17,1088,Dante Exum,25,85,PG,428,22,DAL,49,149
30,105,,14,103,.539,154,88,.561,157,66,.347,190,.444,347,51,.944,54,43,6,1103,Josh Richardson,18,76,SG,425,24,MIA,36,121
22,80,,11,158,.462,165,117,.478,245,48,.293,164,.403,409,47,.691,68,65,13,1177,David Roddy,53,72,PF,425,27,2TM,57,211
22,76,,11,149,.462,155,108,.470,230,47,.301,156,.402,386,46,.687,67,48,13,1114,David Roddy,51,68,PF,403,25,MEM,54,200
22,4,,0,9,.457,10,9,.600,15,1,.125,8,.435,23,1,1.000,1,17,0,63,David Roddy,2,4,PF,22,2,PHO,3,11
30,262,,7,74,.488,159,116,.537,216,43,.279,154,.430,370,61,.813,75,60,21,1176,Vasilije MiciÄ,14,68,PG,422,31,2TM,99,88
30,76,,3,23,.467,37,26,.565,46,11,.244,45,.407,91,14,.737,19,30,0,361,Vasilije MiciÄ,1,22,PG,99,9,OKC,29,24
30,186,,4,51,.495,122,90,.529,170,32,.294,109,.437,279,47,.839,56,30,21,815,Vasilije MiciÄ,13,46,PG,323,22,CHO,70,64
25,114,,16,113,.493,139,62,.425,146,77,.360,214,.386,360,66,.835,79,38,33,1023,De'Anthony Melton,28,84,SG,421,60,PHI,39,141
22,75,,9,145,.474,150,92,.487,189,58,.307,189,.397,378,62,.827,75,51,15,1038,Ziaire Williams,35,85,SF,420,36,MEM,66,180
28,72,,19,196,.576,143,59,.578,102,84,.384,219,.445,321,49,.700,70,58,0,1158,Trey Lyles,61,86,PF,419,17,SAC,38,257
22,85,,44,228,.578,168,164,.588,279,4,.267,15,.571,294,75,.610,123,61,1,921,Day'Ron Sharpe,161,131,C,415,24,BRK,70,389
27,70,,30,145,.581,153,77,.562,137,76,.396,192,.465,329,23,.639,36,66,26,1366,Haywood Highsmith,65,117,PF,405,53,MIA,34,210
25,117,,15,103,.525,142,64,.464,138,78,.377,207,.412,345,35,.673,52,56,0,1028,Jose Alvarado,25,89,PG,397,59,NOP,40,128
26,30,6MOY-6,70,187,.584,146,104,.598,174,42,.375,112,.510,286,59,.720,82,58,2,914,Jonathan Isaac,73,64,PF,393,43,ORL,27,260
22,50,6MOY-9,61,144,.665,155,155,.677,229,0,.000,4,.665,233,73,.716,102,59,3,771,Isaiah Jackson,94,137,C,383,34,IND,39,238
22,165,,3,129,.533,145,98,.516,190,47,.373,126,.459,316,45,.763,59,41,28,987,Tre Mann,20,48,PG,382,51,2TM,65,149
22,20,,0,20,.600,20,12,.571,21,8,.421,19,.500,40,1,1.000,1,13,0,119,Tre Mann,4,3,PG,49,3,OKC,9,24
22,145,,3,109,.524,125,86,.509,169,39,.364,107,.453,276,44,.759,58,28,28,868,Tre Mann,16,45,PG,333,48,CHO,56,125
25,130,,8,93,.505,136,80,.513,156,56,.331,169,.418,325,52,.732,71,69,0,876,Malachi Flynn,21,66,PG,380,38,3TM,63,114
25,73,,6,52,.511,56,28,.491,57,28,.350,80,.409,137,17,.773,22,31,0,474,Malachi Flynn,13,42,PG,157,18,TOR,33,65
25,6,,0,6,.478,9,5,.500,10,4,.308,13,.391,23,9,.818,11,14,0,60,Malachi Flynn,0,3,PG,31,1,NYK,3,6
25,51,,2,35,.503,71,47,.528,89,24,.316,76,.430,165,26,.684,38,24,0,342,Malachi Flynn,8,21,PG,192,19,DET,27,43
26,63,,61,219,.607,152,149,.596,250,3,1.000,3,.601,253,72,.774,93,75,6,1169,Drew Eubanks,103,115,C,379,27,PHO,61,322
22,58,,12,77,.477,118,65,.442,147,53,.340,156,.389,303,90,.826,109,35,6,806,Jake LaRavia,51,69,PF,379,29,MEM,45,128
25,134,,3,76,.540,146,89,.539,165,57,.361,158,.452,323,30,.714,42,72,4,1101,Davion Mitchell,19,85,PG,379,17,SAC,43,95
23,80,,21,139,.463,145,96,.525,183,49,.268,183,.396,366,37,.661,56,62,29,1348,Kris Murray,85,92,SF,376,53,POR,55,224
31,61,,51,159,.577,156,130,.586,222,26,.366,71,.532,293,38,.760,50,60,3,1015,Daniel Theis,85,127,C,376,21,2TM,42,244
31,0,,0,0,.250,1,1,.333,3,0,.000,1,.250,4,0,,0,1,0,8,Daniel Theis,0,1,C,2,0,IND,0,0
31,61,,51,159,.581,155,129,.589,219,26,.371,70,.536,289,38,.760,50,59,3,1007,Daniel Theis,85,126,C,374,21,LAC,42,244
29,87,,14,67,.569,131,55,.598,92,76,.371,205,.441,297,34,.756,45,54,27,1297,Gary Harris,24,91,SG,372,49,ORL,31,91
26,203,,12,114,.482,147,115,.502,229,32,.294,109,.435,338,43,.741,58,56,2,1059,Dennis Smith Jr.,50,121,PG,369,68,BRK,68,164
25,155,,18,165,.424,141,99,.411,241,42,.298,141,.369,382,44,.746,59,57,12,1055,Jordan Goodwin,88,76,PG,368,48,2TM,56,253
25,78,,9,77,.448,75,52,.460,113,23,.288,80,.389,193,25,.862,29,40,0,558,Jordan Goodwin,40,43,PG,198,23,PHO,29,117
25,77,,9,88,.399,66,47,.367,128,19,.311,61,.349,189,19,.633,30,17,12,497,Jordan Goodwin,48,33,PG,170,25,MEM,27,136
25,62,,13,121,.535,138,94,.560,168,44,.336,131,.462,299,44,.830,53,52,1,712,Jordan Nwora,28,48,SF,364,26,2TM,53,149
25,18,,1,25,.518,37,26,.565,46,11,.306,36,.451,82,9,.818,11,18,0,183,Jordan Nwora,8,19,SF,94,6,IND,12,33
25,44,,12,96,.541,101,68,.557,122,33,.347,95,.465,217,35,.833,42,34,1,529,Jordan Nwora,20,29,SF,270,20,TOR,41,116
23,66,,7,85,.495,122,41,.466,88,81,.338,240,.372,328,34,.756,45,51,18,1025,Quentin Grimes,15,75,SG,359,35,2TM,28,100
23,52,,3,74,.530,113,36,.486,74,77,.363,212,.395,286,24,.706,34,45,18,910,Quentin Grimes,14,66,SG,327,30,NYK,21,88
23,14,,4,11,.262,9,5,.357,14,4,.143,28,.214,42,10,.909,11,6,0,115,Quentin Grimes,1,9,SG,32,5,DET,7,12
28,94,,16,49,.484,138,61,.466,131,77,.329,234,.378,365,4,.571,7,72,0,1004,Jevon Carter,11,71,PG,357,37,CHI,36,60
29,254,,28,139,.535,147,106,.525,202,41,.369,111,.470,313,22,.688,32,66,32,1249,Kris Dunn,50,135,PG,357,68,UTA,79,189
20,164,,25,174,.514,139,97,.551,176,42,.311,135,.447,311,34,.642,53,61,16,1358,Dyson Daniels,62,101,PG,354,85,NOP,59,236
26,90,,49,106,.524,126,46,.535,86,80,.346,231,.397,317,22,.759,29,65,19,1487,Matisse Thybulle,30,93,SF,354,113,POR,40,136
20,90,,14,167,.568,127,62,.525,118,65,.399,163,.452,281,33,.702,47,46,38,896,Nikola JoviÄ,25,82,PF,352,25,MIA,42,192
32,70,,2,49,.599,123,29,.527,55,94,.410,229,.433,284,11,.579,19,64,0,904,Doug McDermott,10,64,SF,351,16,2TM,28,59
32,57,,2,40,.619,95,19,.452,42,76,.439,173,.442,215,10,.588,17,46,0,700,Doug McDermott,8,48,SF,276,11,SAS,24,48
32,13,,0,9,.536,28,10,.769,13,18,.321,56,.406,69,1,.500,2,18,0,204,Doug McDermott,2,16,SF,75,5,IND,4,11
31,113,,19,213,.629,138,111,.631,176,27,.415,65,.573,241,47,.770,61,61,0,1216,Larry Nance Jr.,94,98,C,350,61,NOP,49,307
28,49,,33,215,.532,123,88,.587,150,35,.307,114,.466,264,66,.702,94,50,1,872,Christian Wood,39,72,PF,347,16,LAL,50,254
25,120,,15,82,.479,154,150,.487,308,4,.222,18,.472,326,23,.697,33,43,18,910,Markelle Fultz,56,65,PG,335,42,ORL,50,138
28,67,,61,143,.702,142,141,.698,202,1,1.000,1,.700,203,49,.907,54,63,7,983,Luke Kornet,118,77,C,334,23,BOS,21,261
27,133,,29,276,.597,139,139,.599,232,0,.000,1,.597,233,56,.675,83,74,36,1195,Kevon Looney,143,155,C,334,28,GSW,50,419
26,46,,16,153,.561,123,95,.633,150,28,.298,94,.504,244,58,.906,64,51,12,859,Chimezie Metu,41,71,C,332,43,2TM,52,194
26,19,,9,86,.565,66,51,.646,79,15,.294,51,.508,130,38,.884,43,37,5,448,Chimezie Metu,24,39,C,185,19,PHO,27,110
26,27,,7,67,.557,57,44,.620,71,13,.302,43,.500,114,20,.952,21,14,7,411,Chimezie Metu,17,32,C,147,24,DET,25,84
26,54,,10,46,.527,118,65,.556,117,53,.338,157,.431,274,38,.826,46,46,5,726,Landry Shamet,16,76,SG,327,25,WAS,30,62
27,37,,8,75,.644,103,18,.545,33,85,.440,193,.456,226,34,.810,42,66,5,992,Garrison Mathews,17,115,SG,325,20,ATL,19,92
29,93,,9,148,.568,131,75,.540,139,56,.397,141,.468,280,7,.500,14,69,1,1029,Kenrich Williams,61,101,PF,325,38,OKC,32,209
31,23,,24,145,.578,110,79,.642,123,31,.330,94,.507,217,71,.772,92,50,0,705,Chris Boucher,62,68,PF,322,14,TOR,28,207
35,128,,38,178,.596,116,43,.606,71,73,.395,185,.453,256,15,.714,21,60,38,1529,Nicolas Batum,70,109,PF,320,48,2TM,40,248
35,5,,4,7,.500,3,1,1.000,1,2,.286,7,.375,8,0,,0,3,0,54,Nicolas Batum,0,5,PF,8,3,LAC,1,7
35,123,,34,171,.599,113,42,.600,70,71,.399,178,.456,248,15,.714,21,57,38,1475,Nicolas Batum,70,104,PF,312,45,PHI,39,241
20,91,,21,106,.540,115,78,.510,153,37,.394,94,.466,247,49,.613,80,69,33,1164,Anthony Black,33,110,PG,316,35,ORL,56,139
34,36,,13,111,.530,116,68,.469,145,48,.403,119,.439,264,36,.818,44,49,7,817,Marcus Morris,23,74,PF,316,15,2TM,30,134
34,26,,11,91,.527,90,54,.470,115,36,.400,90,.439,205,31,.861,36,37,7,637,Marcus Morris,18,61,PF,247,13,PHI,19,109
34,10,,2,20,.542,26,14,.467,30,12,.414,29,.441,59,5,.625,8,12,0,180,Marcus Morris,5,13,PF,69,2,CLE,11,25
33,66,,9,130,.530,114,56,.538,104,58,.349,166,.422,270,26,.722,36,50,25,1156,Jae Crowder,31,74,PF,312,38,MIL,23,161
24,79,,72,177,.608,126,124,.636,195,2,.143,14,.603,209,57,.655,87,62,33,957,Goga Bitadze,109,107,C,311,32,ORL,44,286
24,85,,29,92,.612,107,37,.578,64,70,.417,168,.461,232,26,.743,35,57,21,978,Keon Ellis,32,112,SG,310,51,SAC,37,124
33,58,,21,148,.550,108,48,.490,98,60,.392,153,.430,251,27,.750,36,53,14,1049,Torrey Craig,69,110,SF,303,30,CHI,32,217
23,33,,29,142,.720,126,126,.754,167,0,.000,8,.720,175,51,.622,82,70,5,877,Jaxson Hayes,69,123,C,303,34,LAL,43,211
21,51,,10,85,.513,101,67,.523,128,34,.333,102,.439,230,66,.776,85,59,14,882,Bryce McGowens,17,74,SG,302,21,CHO,30,102
19,59,,7,54,.500,113,50,.350,143,63,.432,146,.391,289,13,.867,15,51,0,729,Nick Smith Jr.,18,55,SG,302,10,CHO,39,72
36,203,,5,124,.590,99,29,.439,66,70,.435,161,.436,227,28,.824,34,68,0,1169,Joe Ingles,18,88,SF,296,43,ORL,67,142
20,32,,30,139,.560,108,55,.550,100,53,.379,140,.450,240,23,.793,29,40,23,856,Taylor Hendricks,46,77,PF,292,28,UTA,27,185
27,43,,25,181,.584,96,17,.567,30,79,.391,202,.414,232,20,.769,26,54,32,1108,Dean Wade,37,93,PF,291,40,CLE,20,218
31,35,,12,52,.556,92,16,.471,34,76,.380,200,.393,234,30,.909,33,43,1,674,DÄvis BertÄns,9,56,PF,290,26,2TM,18,61
31,9,,3,8,.577,10,0,.000,2,10,.417,24,.385,26,14,.933,15,15,0,91,DÄvis BertÄns,2,10,PF,44,3,OKC,1,10
31,26,,9,44,.553,82,16,.500,32,66,.375,176,.394,208,16,.889,18,28,1,583,DÄvis BertÄns,7,46,PF,246,23,CHO,17,51
22,205,,20,108,.452,117,95,.455,209,22,.297,74,.413,283,33,.660,50,42,31,1008,Killian Hayes,11,75,PG,289,36,DET,51,119
29,86,,5,47,.519,102,60,.583,103,42,.313,134,.430,237,43,.768,56,20,20,605,Marcus Smart,6,53,PG,289,41,MEM,62,53
23,118,,15,88,.535,116,104,.536,194,12,.353,34,.509,228,41,.732,56,51,6,649,Craig Porter Jr.,21,40,PG,285,21,CLE,45,109
20,60,,17,127,.515,103,61,.496,123,42,.356,118,.427,241,36,.783,46,67,7,944,Max Christie,15,57,SG,284,20,LAL,35,142
25,77,,44,141,.470,121,101,.510,198,20,.247,81,.434,279,22,.440,50,54,15,974,Xavier Tillman Sr.,70,75,PF,284,51,2TM,34,211
25,57,,35,101,.437,87,75,.469,160,12,.226,53,.408,213,18,.419,43,34,13,700,Xavier Tillman Sr.,56,60,C,204,42,MEM,29,157
25,20,,9,40,.576,34,26,.684,38,8,.286,28,.515,66,4,.571,7,20,2,274,Xavier Tillman Sr.,14,15,PF,80,9,BOS,5,54
25,46,,28,134,.583,109,109,.596,183,0,.000,4,.583,187,64,.667,96,45,2,682,Bruno Fernando,59,107,C,282,25,ATL,44,193
35,55,,6,88,.516,83,53,.546,97,30,.323,93,.437,190,84,.857,98,49,0,630,Danilo Gallinari,20,50,SF,280,14,3TM,23,108
35,31,,3,64,.511,57,37,.552,67,20,.313,64,.435,131,47,.839,56,26,0,385,Danilo Gallinari,12,26,PF,181,6,WAS,12,76
35,12,,2,12,.705,12,5,.500,10,7,.583,12,.545,22,21,.875,24,6,0,90,Danilo Gallinari,2,9,SF,52,2,DET,1,14
35,12,,1,12,.419,14,11,.550,20,3,.176,17,.378,37,16,.889,18,17,0,155,Danilo Gallinari,6,15,SF,47,6,MIL,10,18
25,64,,24,80,.488,86,57,.509,112,29,.309,94,.417,206,76,.745,102,60,11,960,Josh Okogie,74,68,SG,277,48,PHO,36,154
21,110,,27,198,.533,95,42,.500,84,53,.368,144,.417,228,33,.805,41,69,1,897,Jaylin Williams,36,98,C,276,28,OKC,34,234
28,65,,33,84,.539,106,96,.578,166,10,.250,40,.515,206,52,.800,65,56,3,763,Jock Landale,88,74,C,274,20,HOU,31,172
26,28,,22,91,.479,108,94,.485,194,14,.304,46,.450,240,42,.778,54,38,3,559,Lamar Stevens,36,45,PF,272,23,2TM,24,127
26,8,,5,19,.500,21,18,.486,37,3,.375,8,.467,45,8,.727,11,19,1,122,Lamar Stevens,12,14,PF,53,6,BOS,9,31
26,20,,17,72,.474,87,76,.484,157,11,.289,38,.446,195,34,.791,43,19,2,437,Lamar Stevens,24,31,PF,219,17,MEM,15,96
23,98,,10,45,.567,100,70,.534,131,30,.417,72,.493,203,41,.745,55,21,16,527,Scotty Pippen Jr.,22,60,PG,271,36,MEM,56,67
20,166,,9,76,.502,102,90,.563,160,12,.218,55,.474,215,52,.667,78,61,3,876,Blake Wesley,18,89,SG,268,29,SAS,55,94
28,64,,15,136,.522,108,85,.559,152,23,.299,77,.472,229,26,.667,39,65,9,1031,Jae'Sean Tate,61,137,SF,265,42,HOU,37,197
24,48,,14,72,.468,91,54,.435,124,37,.336,110,.389,234,41,.759,54,48,26,984,Cam Reddish,27,64,SF,260,47,LAL,31,99
23,93,,4,50,.474,97,53,.457,116,44,.326,135,.386,251,18,.783,23,37,5,540,Bones Hyland,5,51,PG,256,26,LAC,44,55
25,41,,60,161,.553,97,72,.537,134,25,.391,64,.490,198,34,.680,50,57,17,740,Mo Bamba,77,101,C,253,22,PHI,39,238
21,29,,4,56,.563,80,8,.615,13,72,.373,193,.388,206,21,.808,26,59,13,815,Caleb Houstan,28,61,SF,253,15,ORL,16,84
24,30,,4,55,.599,83,14,.519,27,69,.408,169,.423,196,17,.895,19,56,0,614,A.J. Green,9,49,SG,252,9,MIL,12,64
22,53,,2,74,.500,90,41,.562,73,49,.314,156,.393,229,23,.885,26,57,1,814,Ben Sheppard,15,88,SG,252,33,IND,15,89
23,126,,8,49,.547,98,74,.602,123,24,.308,78,.488,201,31,.861,36,40,0,566,Jared Butler,9,58,SG,251,29,WAS,50,58
24,60,,3,119,.476,84,37,.435,85,47,.333,141,.372,226,32,.865,37,59,15,827,Troy Brown Jr.,25,42,SF,247,24,2TM,30,144
24,35,,2,58,.572,52,21,.618,34,31,.369,84,.441,118,19,.864,22,37,3,410,Troy Brown Jr.,14,26,SF,154,8,MIN,18,72
24,25,,1,61,.370,32,16,.314,51,16,.281,57,.296,108,13,.867,15,22,12,417,Troy Brown Jr.,11,16,SF,93,16,DET,12,72
33,55,,17,174,.569,87,87,.592,147,0,.000,6,.569,153,70,.707,99,46,11,674,Mason Plumlee,60,68,C,244,14,LAC,36,234
22,22,,20,108,.649,98,98,.649,151,0,,0,.649,151,46,.719,64,19,19,508,Mark Williams,76,50,C,242,16,CHO,17,184
20,55,,6,86,.468,85,51,.495,103,34,.296,115,.390,218,37,.902,41,32,11,584,Brice Sensabaugh,16,43,SF,241,13,UTA,47,102
31,48,,18,67,.617,103,83,.648,128,20,.364,55,.563,183,14,.609,23,44,0,680,Gary Payton II,46,77,SG,240,39,GSW,27,113
27,110,,51,185,.514,88,50,.568,88,38,.317,120,.423,208,21,.840,25,55,23,1173,John Konchar,72,76,SF,235,51,MEM,46,257
34,67,,9,62,.595,88,33,.569,58,55,.404,136,.454,194,3,.750,4,58,9,862,Justin Holiday,9,69,SG,234,36,DEN,14,71
26,44,,8,80,.486,80,36,.434,83,44,.346,127,.381,210,26,.788,33,59,11,719,Chris Duarte,26,80,SF,230,28,SAC,26,106
21,47,,7,56,.462,82,41,.488,84,41,.297,138,.369,222,22,.710,31,50,0,545,Julian Strawther,5,54,SF,227,17,DEN,23,61
24,73,,5,44,.512,80,66,.555,119,14,.275,51,.471,170,52,.813,64,9,9,318,Ja Morant,6,19,PG,226,7,MEM,27,50
33,44,,6,50,.485,80,42,.438,96,38,.352,108,.392,204,28,.903,31,44,4,616,Seth Curry,18,39,SG,226,22,2TM,21,68
33,30,,3,37,.472,54,25,.385,65,29,.363,80,.372,145,17,.895,19,36,3,457,Seth Curry,15,32,SG,154,17,DAL,16,52
33,14,,3,13,.517,26,17,.548,31,9,.321,28,.441,59,11,.917,12,8,1,159,Seth Curry,3,7,SG,72,5,CHO,5,16
28,19,,7,66,.558,84,39,.549,71,45,.375,120,.440,191,12,.800,15,42,0,511,Sasha Vezenkov,30,42,PF,225,20,SAC,12,96
23,51,,12,90,.558,97,89,.582,153,8,.286,28,.536,181,22,.537,41,60,2,746,KJ Martin,41,100,SF,224,22,2TM,32,131
23,1,,1,2,.450,4,3,.600,5,1,.200,5,.400,10,1,.500,2,2,0,31,KJ Martin,1,3,SF,10,2,LAC,2,3
23,50,,11,88,.564,93,86,.581,148,7,.304,23,.544,171,21,.538,39,58,2,715,KJ Martin,40,97,SF,214,20,PHI,30,128
24,17,,25,105,.689,93,71,.717,99,22,.423,52,.616,151,15,.789,19,43,0,469,Bol Bol,32,42,PF,223,10,PHO,19,137
24,23,,7,57,.546,86,55,.598,92,31,.330,94,.462,186,20,.909,22,31,11,560,Kevin Knox,18,50,SF,223,13,DET,22,75
25,29,,18,136,.552,99,94,.588,160,5,.208,24,.538,184,19,.679,28,48,12,545,Omer Yurtseven,72,52,C,222,8,UTA,37,208
31,48,,7,53,.432,79,46,.505,91,33,.254,130,.357,221,29,.806,36,32,0,580,Evan Fournier,5,48,SG,220,29,2TM,21,58
31,3,,0,4,.250,4,2,.400,5,2,.133,15,.200,20,2,1.000,2,3,0,39,Evan Fournier,0,4,SG,12,4,NYK,1,4
31,45,,7,49,.450,75,44,.512,86,31,.270,115,.373,201,27,.794,34,29,0,541,Evan Fournier,5,44,SG,208,25,DET,20,54
26,23,,16,101,.591,86,82,.646,127,4,.182,22,.577,149,41,.872,47,38,4,441,Thomas Bryant,40,46,C,217,10,MIA,21,141
27,60,,6,61,.451,79,61,.466,131,18,.281,64,.405,195,40,.816,49,48,0,581,Shake Milton,14,54,SG,216,19,3TM,31,75
27,50,,5,44,.444,64,50,.467,107,14,.264,53,.400,160,36,.818,44,38,0,491,Shake Milton,7,44,SG,178,16,MIN,28,51
27,6,,1,11,.481,11,8,.471,17,3,.333,9,.423,26,2,.667,3,4,0,63,Shake Milton,7,3,SG,27,2,DET,3,18
27,4,,0,6,.500,4,3,.429,7,1,.500,2,.444,9,2,1.000,2,6,0,27,Shake Milton,0,7,SG,11,1,NYK,0,6
22,27,,19,107,.513,88,70,.504,139,18,.360,50,.466,189,21,.636,33,22,0,480,Tari Eason,46,51,PF,215,31,HOU,20,153
23,45,,4,84,.492,76,52,.495,105,24,.324,74,.425,179,38,.826,46,43,3,664,Jalen Wilson,47,48,PF,214,11,BRK,19,131
23,31,,7,77,.578,81,51,.560,91,30,.400,75,.488,166,19,.679,28,48,1,608,MarJon Beauchamp,22,54,SF,211,13,MIL,27,99
28,104,,18,90,.444,82,55,.426,129,27,.314,86,.381,215,20,.606,33,28,22,753,Cody Martin,19,48,SF,211,32,CHO,44,109
31,119,,11,67,.460,74,49,.408,120,25,.368,68,.394,188,37,.822,45,47,1,742,Delon Wright,19,32,PG,210,54,2TM,14,86
31,82,,8,46,.451,48,34,.405,84,14,.368,38,.393,122,24,.828,29,33,0,456,Delon Wright,13,22,PG,134,35,WAS,11,59
31,37,,3,21,.477,26,15,.417,36,11,.367,30,.394,66,13,.813,16,14,1,286,Delon Wright,6,10,PG,76,19,MIA,3,27
32,84,,20,117,.684,72,71,.689,103,1,.333,3,.679,106,63,.708,89,63,9,836,Dwight Powell,97,113,C,208,26,DAL,32,214
26,35,,5,50,.524,81,68,.562,121,13,.283,46,.485,167,32,.653,49,43,0,393,Eugene Omoruyi,35,62,SF,207,27,WAS,21,85
25,44,,8,99,.493,68,53,.541,98,15,.273,55,.444,153,50,.602,83,55,1,630,Oshae Brissett,61,54,SF,201,19,BOS,20,160
21,29,,27,103,.514,80,52,.510,102,28,.346,81,.437,183,11,.550,20,63,3,781,JT Thor,43,60,PF,199,11,CHO,15,146
30,25,,19,111,.561,82,81,.563,144,1,.333,3,.558,147,34,.723,47,40,10,555,Richaun Holmes,71,74,C,199,11,2TM,24,182
30,15,,9,45,.559,33,33,.559,59,0,,0,.559,59,12,.571,21,23,2,237,Richaun Holmes,33,33,C,78,3,DAL,12,78
30,10,,10,66,.563,49,48,.565,85,1,.333,3,.557,88,22,.846,26,17,8,318,Richaun Holmes,38,41,PF,121,8,WAS,12,104
28,38,,22,79,.497,72,51,.526,97,21,.304,69,.434,166,32,.762,42,53,8,665,Keita Bates-Diop,31,35,SF,197,25,2TM,15,110
28,34,,20,71,.493,64,44,.512,86,20,.313,64,.427,150,26,.722,36,39,8,597,Keita Bates-Diop,30,33,SF,174,22,PHO,13,101
28,4,,2,8,.531,8,7,.636,11,1,.200,5,.500,16,6,1.000,6,14,0,68,Keita Bates-Diop,1,2,SF,23,3,BRK,2,9
27,110,,7,54,.628,70,28,.500,56,42,.472,89,.483,145,13,.722,18,56,0,626,Jordan McLaughlin,18,31,PG,195,35,MIN,19,72
32,68,,30,113,.541,63,31,.574,54,32,.348,92,.432,146,33,.702,47,43,7,871,Maxi Kleber,30,79,C,191,17,DAL,28,143
35,78,,2,38,.506,76,61,.492,124,15,.366,41,.461,165,24,.889,27,24,7,399,Derrick Rose,7,21,PG,191,8,MEM,31,45
24,49,,12,102,.532,73,54,.593,91,19,.297,64,.471,155,25,.735,34,46,5,451,Sandro Mamukelashvili,45,35,C,190,7,SAS,19,147
31,34,,11,57,.500,75,65,.546,119,10,.244,41,.469,160,29,.806,36,50,3,466,Anthony Gill,37,48,PF,189,13,WAS,23,94
23,32,,38,65,.483,69,63,.500,126,6,.261,23,.463,149,42,.677,62,58,0,576,Zeke Nnaji,61,81,PF,186,15,DEN,27,126
36,17,,20,84,.602,79,78,.624,125,1,.143,7,.598,132,26,.578,45,46,0,339,JaVale McGee,42,46,C,185,14,SAC,34,126
21,81,,18,84,.494,69,52,.627,83,17,.230,74,.439,157,25,.581,43,59,2,681,Dalen Terry,29,81,SG,180,27,CHI,32,113
24,19,,7,80,.421,60,47,.500,94,13,.203,64,.380,158,44,.786,56,43,7,404,Luka Å amaniÄ,22,32,PF,177,5,UTA,28,102
31,53,,37,147,.565,74,74,.565,131,0,,0,.565,131,26,.481,54,40,27,791,Bismack Biyombo,62,89,C,174,11,2TM,42,209
31,51,,34,134,.563,67,67,.563,119,0,,0,.563,119,22,.478,46,30,27,718,Bismack Biyombo,57,82,C,156,10,MEM,38,191
31,2,,3,13,.583,7,7,.583,12,0,,0,.583,12,4,.500,8,10,0,73,Bismack Biyombo,5,7,C,18,1,OKC,4,18
22,16,,1,32,.536,54,42,.525,80,12,.375,32,.482,112,53,.746,71,32,0,289,Ricky Council IV,14,17,SG,173,8,PHI,5,46
25,137,,5,37,.570,60,9,.375,24,51,.405,126,.400,150,2,1.000,2,41,14,699,Jacob Gilyard,9,39,PG,173,33,2TM,30,46
25,131,,5,35,.594,60,9,.375,24,51,.425,120,.417,144,2,1.000,2,37,14,654,Jacob Gilyard,8,35,PG,173,27,MEM,29,43
25,6,,0,2,.000,0,0,,0,0,.000,6,.000,6,0,,0,4,0,45,Jacob Gilyard,1,4,PG,0,6,BRK,1,3
25,18,,35,121,.575,73,73,.575,127,0,,0,.575,127,27,.409,66,31,21,768,Mitchell Robinson,142,55,C,173,37,NYK,25,263
24,27,,28,70,.551,75,75,.551,136,0,,0,.551,136,21,.840,25,25,14,573,Trey Jemison,64,69,C,171,12,2TM,34,134
24,0,,0,1,,0,0,,0,0,,0,,0,0,,0,2,0,1,Trey Jemison,0,0,C,0,0,WAS,1,1
24,27,,28,69,.551,75,75,.551,136,0,,0,.551,136,21,.840,25,23,14,572,Trey Jemison,64,69,C,171,12,MEM,33,133
26,37,,6,61,.376,65,53,.449,118,12,.169,71,.344,189,27,.730,37,50,1,538,Jalen McDaniels,18,52,SF,169,19,TOR,30,79
21,29,,15,106,.481,59,28,.483,58,31,.320,97,.381,155,19,.679,28,38,7,493,Patrick Baldwin Jr.,17,56,SF,168,18,WAS,19,123
22,13,,8,33,.447,65,51,.468,109,14,.269,52,.404,161,23,.697,33,32,0,345,Brandon Boston Jr.,19,40,SF,167,11,LAC,24,52
23,36,,2,51,.511,56,24,.453,53,32,.364,88,.397,141,20,.690,29,37,0,394,Lester QuiÃ±ones,21,44,SG,164,6,GSW,17,72
28,69,,9,50,.493,62,35,.422,83,27,.386,70,.405,153,13,.684,19,33,0,476,Monte Morris,7,14,PG,164,19,2TM,7,57
28,8,,1,10,.394,12,10,.455,22,2,.182,11,.364,33,1,.500,2,6,0,68,Monte Morris,2,1,PG,27,1,DET,2,12
28,61,,8,40,.521,50,25,.410,61,25,.424,59,.417,120,12,.706,17,27,0,408,Monte Morris,5,13,PG,137,18,MIN,5,45
21,44,,15,45,.432,59,49,.490,100,10,.208,48,.399,148,35,.833,42,49,2,507,Jaden Springer,33,66,PG,163,36,2TM,34,78
21,35,,11,33,.424,46,38,.469,81,8,.216,37,.390,118,28,.824,34,32,1,377,Jaden Springer,25,49,SG,128,25,PHI,26,58
21,9,,4,12,.467,13,11,.579,19,2,.182,11,.433,30,7,.875,8,17,1,130,Jaden Springer,8,17,PG,35,11,BOS,8,20
26,35,,1,40,.569,57,15,.517,29,42,.389,108,.416,137,6,.667,9,41,2,413,Svi Mykhailiuk,11,19,SF,162,11,BOS,12,51
32,51,,14,101,.608,73,73,.613,119,0,.000,1,.608,120,15,.288,52,49,0,549,Tristan Thompson,73,59,C,161,12,CLE,29,174
32,36,,13,86,.449,56,28,.467,60,28,.292,96,.359,156,17,.680,25,53,6,600,Mike Muscala,39,52,C,157,9,3TM,22,125
32,22,,7,53,.444,33,19,.487,39,14,.275,51,.367,90,15,.750,20,24,2,338,Mike Muscala,22,31,C,95,5,WAS,16,75
32,10,,5,19,.489,15,2,.200,10,13,.382,34,.341,44,2,.500,4,13,4,171,Mike Muscala,10,13,C,45,3,DET,2,29
32,4,,1,14,.386,8,7,.636,11,1,.091,11,.364,22,0,.000,1,16,0,91,Mike Muscala,7,8,C,17,1,OKC,4,21
19,62,,3,68,.422,54,26,.313,83,28,.359,78,.335,161,19,.760,25,39,12,633,Rayan Rupert,24,56,SG,155,12,POR,31,92
26,85,,4,33,.447,63,47,.448,105,16,.296,54,.396,159,13,.765,17,38,5,433,Skylar Mays,10,26,SG,155,21,2TM,20,43
26,75,,3,28,.435,53,39,.438,89,14,.286,49,.384,138,13,.765,17,21,5,356,Skylar Mays,9,20,PG,133,14,POR,18,37
26,10,,1,5,.524,10,8,.500,16,2,.400,5,.476,21,0,,0,17,0,77,Skylar Mays,1,6,SG,22,7,LAL,2,6
24,20,,21,69,.644,67,67,.644,104,0,,0,.644,104,20,.714,28,28,0,333,Neemias Queta,53,50,C,154,13,BOS,13,122
24,40,,4,54,.484,55,45,.549,82,10,.238,42,.444,124,33,.917,36,22,6,403,Javon Freeman-Liberty,16,28,PG,153,10,TOR,25,70
21,32,,10,54,.448,62,48,.421,114,14,.350,40,.403,154,14,.583,24,50,6,613,Johnny Davis,18,57,SG,152,18,WAS,13,72
23,21,,10,61,.544,57,36,.667,54,21,.300,70,.460,124,17,.850,20,45,2,458,Nassir Little,14,39,SF,152,10,PHO,14,75
26,18,,1,34,.615,49,8,.364,22,41,.451,91,.434,113,13,.929,14,28,1,390,Matt Ryan,6,32,SF,152,6,NOP,19,40
24,36,,5,97,.553,59,51,.586,87,8,.296,27,.518,114,24,.667,36,29,6,581,Jarred Vanderbilt,41,43,PF,150,36,LAL,28,138
22,35,,13,72,.479,49,31,.470,66,18,.327,55,.405,121,30,.732,41,28,0,405,Aleksej Pokusevski,17,22,PF,146,15,2TM,19,89
22,5,,1,8,.313,4,2,.400,5,2,.182,11,.250,16,2,.500,4,10,0,60,Aleksej Pokusevski,2,5,PF,12,1,OKC,3,10
22,30,,12,64,.505,45,29,.475,61,16,.364,44,.429,105,28,.757,37,18,0,345,Aleksej Pokusevski,15,17,PF,134,14,CHO,16,79
20,36,,14,68,.509,56,53,.510,104,3,.333,9,.496,113,29,.690,42,33,1,420,Dominick Barlow,45,47,PF,144,12,SAS,9,113
30,28,,5,42,.519,47,32,.582,55,15,.300,50,.448,105,35,.761,46,34,4,509,Danuel House Jr.,16,45,SF,144,15,PHI,19,58
22,23,,2,29,.609,51,19,.576,33,32,.416,77,.464,110,10,.714,14,20,5,372,Johnny Juzang,7,29,SG,144,4,UTA,13,36
35,26,,16,103,.624,58,58,.624,93,0,,0,.624,93,26,.491,53,36,2,396,DeAndre Jordan,54,56,C,142,6,DEN,23,157
35,145,,4,65,.430,66,62,.413,150,4,.500,8,.418,158,3,.750,4,43,5,741,Ish Smith,11,49,PG,139,17,CHO,47,76
26,24,,7,33,.649,49,12,.632,19,37,.435,85,.471,104,2,1.000,2,38,0,280,Lindy Waters III,7,23,SG,137,5,OKC,7,40
35,57,,5,57,.606,65,64,.634,101,1,.143,7,.602,108,6,.400,15,33,6,439,Thaddeus Young,46,49,PF,137,23,2TM,15,103
35,50,,3,46,.626,54,53,.654,81,1,.167,6,.621,87,5,.417,12,23,6,350,Thaddeus Young,29,38,PF,114,18,TOR,11,75
35,7,,2,11,.524,11,11,.550,20,0,.000,1,.524,21,1,.333,3,10,0,89,Thaddeus Young,17,11,PF,23,5,PHO,4,28
23,20,,3,36,.500,54,41,.577,71,13,.260,50,.446,121,15,.652,23,42,0,311,A.J. Lawson,14,22,SG,136,10,DAL,14,50
23,50,,6,41,.625,51,23,.639,36,28,.412,68,.490,104,5,.833,6,22,14,541,Vit Krejci,11,48,PG,135,13,ATL,20,52
19,18,,16,55,.602,50,38,.633,60,12,.364,33,.538,93,21,.700,30,23,4,370,Noah Clowney,26,25,PF,133,8,BRK,15,81
20,37,,5,41,.513,49,28,.609,46,21,.300,70,.422,116,14,.875,16,33,0,365,Ousmane Dieng,10,22,PF,133,8,OKC,19,51
24,11,,7,43,.583,37,13,.419,31,24,.453,53,.440,84,29,.906,32,24,2,307,Stanley Umude,8,40,SG,127,8,DET,14,51
33,24,,18,66,.536,43,24,.571,42,19,.339,56,.439,98,22,.846,26,29,6,488,Robert Covington,31,56,PF,127,39,2TM,11,97
33,7,,2,6,.444,3,1,1.000,1,2,.250,8,.333,9,1,.500,2,3,3,69,Robert Covington,2,7,PF,9,6,LAC,0,8
33,17,,16,60,.545,40,23,.561,41,17,.354,48,.449,89,21,.875,24,26,3,419,Robert Covington,29,49,SF,118,33,PHI,11,89
35,34,,1,26,.443,46,22,.500,44,24,.276,87,.351,131,11,1.000,11,32,5,415,Patty Mills,9,32,PG,127,20,2TM,16,35
35,14,,1,15,.500,19,6,.353,17,13,.382,34,.373,51,0,,0,19,0,202,Patty Mills,5,17,PG,51,9,ATL,8,20
35,20,,0,11,.406,27,16,.593,27,11,.208,53,.338,80,11,1.000,11,13,5,213,Patty Mills,4,15,PG,76,11,MIA,8,15
22,50,,6,70,.585,50,33,.611,54,17,.370,46,.500,100,8,.727,11,57,8,572,Andre Jackson Jr.,43,92,SG,125,16,MIL,28,113
21,22,,4,54,.447,40,27,.458,59,13,.289,45,.385,104,28,.683,41,40,1,336,Olivier-Maxence Prosper,25,20,PF,121,7,DAL,8,79
30,50,,33,82,.617,50,50,.641,78,0,.000,3,.617,81,20,.588,34,48,0,444,Alex Len,46,66,C,120,11,SAC,27,128
20,40,,11,51,.509,45,23,.418,55,22,.400,55,.409,110,8,.889,9,33,0,340,Jarace Walker,12,29,PF,120,15,IND,17,63
29,15,,7,43,.461,41,16,.516,31,25,.294,85,.353,116,10,.588,17,34,0,464,Yuta Watanabe,11,39,SF,117,12,2TM,19,54
29,10,,7,34,.485,35,11,.500,22,24,.320,75,.361,97,10,.667,15,29,0,382,Yuta Watanabe,11,34,SF,104,9,PHO,16,45
29,5,,0,9,.342,6,5,.556,9,1,.100,10,.316,19,0,.000,2,5,0,82,Yuta Watanabe,0,5,SF,13,3,MEM,3,9
24,60,,20,56,.481,40,20,.455,44,20,.333,60,.385,104,15,.833,18,26,5,360,Jontay Porter,26,35,PF,115,20,TOR,21,82
23,21,,4,53,.542,45,32,.571,56,13,.333,39,.474,95,12,.750,16,39,1,334,Jeremiah Robinson-Earl,23,24,PF,115,10,NOP,16,76
28,49,,2,31,.468,38,13,.520,25,25,.301,83,.352,108,13,.813,16,23,0,313,Devonte' Graham,5,14,PG,114,9,SAS,17,36
25,25,,5,33,.440,40,18,.462,39,22,.286,77,.345,116,12,.667,18,23,6,469,Isaiah Livers,15,43,PF,114,13,DET,16,48
30,5,,8,47,.667,45,35,.729,48,10,.370,27,.600,75,10,.769,13,9,5,230,Javonte Green,20,19,SF,110,10,CHI,7,67
37,23,,11,44,.474,34,10,.357,28,24,.348,69,.351,97,18,.750,24,36,3,413,Wesley Matthews,9,43,SG,110,16,ATL,8,53
28,15,,13,42,.618,43,40,.690,58,3,.214,14,.597,72,18,.857,21,39,0,270,Damian Jones,20,27,C,107,7,CLE,13,62
25,20,,7,62,.460,40,17,.567,30,23,.280,82,.357,112,4,.571,7,47,8,432,Chuma Okeke,18,19,SF,107,9,ORL,16,80
22,16,,5,42,.592,36,24,.615,39,12,.375,32,.507,71,17,.680,25,17,8,367,Tosan Evbuomwan,18,23,SF,101,6,2TM,9,60
22,6,,1,6,.333,4,2,.286,7,2,.250,8,.267,15,0,,0,4,0,74,Tosan Evbuomwan,8,5,SF,10,0,MEM,1,14
22,10,,4,36,.661,32,22,.688,32,10,.417,24,.571,56,17,.680,25,13,8,293,Tosan Evbuomwan,10,18,SF,91,6,DET,8,46
25,4,,1,12,.540,36,27,.628,43,9,.281,32,.480,75,18,.720,25,25,0,122,Luka Garza,19,24,C,99,4,MIN,6,31
23,34,,8,56,.556,36,28,.491,57,8,.533,15,.500,72,19,.760,25,36,7,304,Orlando Robinson,28,35,C,99,7,MIA,18,84
24,10,,5,22,.500,34,23,.479,48,11,.355,31,.430,79,18,.783,23,26,1,259,Jamal Cain,15,22,PF,97,10,MIA,8,37
32,15,,5,67,.579,34,7,.467,15,27,.403,67,.415,82,1,1.000,1,44,0,417,Reggie Bullock,6,29,SF,96,12,HOU,10,73
21,33,,5,26,.506,36,29,.537,54,7,.292,24,.462,78,17,.654,26,21,0,199,Kenneth Lofton Jr.,12,24,PF,96,6,3TM,14,38
21,14,,3,13,.419,14,11,.407,27,3,.300,10,.378,37,8,.533,15,15,0,99,Kenneth Lofton Jr.,2,15,PF,39,3,MEM,6,15
21,0,,0,3,.167,1,1,.250,4,0,.000,2,.167,6,0,,0,2,0,9,Kenneth Lofton Jr.,0,0,PF,2,0,PHI,2,3
21,19,,2,10,.657,21,17,.739,23,4,.333,12,.600,35,9,.818,11,4,0,91,Kenneth Lofton Jr.,10,9,PF,55,3,UTA,6,20
23,15,,4,33,.537,34,14,.467,30,20,.385,52,.415,82,5,.556,9,54,0,275,Kessler Edwards,9,26,SF,93,10,SAC,4,42
27,86,,9,88,.581,43,43,.581,74,0,,0,.581,74,6,.400,15,15,12,359,Ben Simmons,31,36,PG,92,12,BRK,27,119
25,25,,19,91,.691,38,38,.691,55,0,,0,.691,55,16,.667,24,45,11,585,Jericho Sims,56,45,C,92,8,NYK,16,147
24,25,,6,42,.489,37,23,.548,42,14,.292,48,.411,90,1,.500,2,44,0,394,Kobe Brown,20,49,PF,89,12,LAC,9,62
22,19,,9,34,.494,32,19,.576,33,13,.289,45,.410,78,12,.800,15,15,1,235,Justin Champagnie,19,14,SF,89,10,WAS,10,53
20,13,,7,24,.494,32,20,.513,39,12,.316,38,.416,77,13,.684,19,40,0,323,Julian Phillips,12,40,SF,89,7,CHI,10,36
22,37,,2,17,.391,34,30,.508,59,4,.121,33,.370,92,17,.850,20,28,0,265,Kira Lewis Jr.,9,13,PG,89,9,3TM,14,26
22,18,,1,10,.327,16,14,.438,32,2,.100,20,.308,52,10,.909,11,15,0,144,Kira Lewis Jr.,4,8,PG,44,5,NOP,8,14
22,0,,0,0,,0,0,,0,0,,0,,0,0,,0,1,0,2,Kira Lewis Jr.,0,1,PG,0,0,TOR,0,0
22,19,,1,7,.475,18,16,.593,27,2,.154,13,.450,40,7,.778,9,12,0,119,Kira Lewis Jr.,5,4,PG,45,4,UTA,6,12
26,25,,3,26,.487,30,16,.444,36,14,.350,40,.395,76,14,.700,20,35,0,300,Furkan Korkmaz,4,17,SG,88,14,PHI,10,30
37,28,,3,27,.449,29,17,.447,38,12,.300,40,.372,78,18,.818,22,27,2,289,Garrett Temple,18,28,SG,88,12,TOR,14,45
24,27,,0,20,.572,32,17,.548,31,15,.395,38,.464,69,8,.667,12,24,0,225,Collin Gillespie,1,24,PG,87,13,DEN,14,21
20,13,,7,30,.507,29,19,.613,31,10,.278,36,.433,67,17,.773,22,10,4,153,Tristan Vukcevic,6,28,C,85,5,WAS,10,36
25,92,,3,40,.389,34,32,.400,80,2,.200,10,.378,90,13,.765,17,38,0,414,Trent Forrest,11,25,SG,83,11,ATL,20,51
24,14,,13,30,.591,33,21,.600,35,12,.387,31,.500,66,5,.625,8,17,0,245,Jared Rhoden,3,28,SG,83,3,DET,7,33
21,14,,2,32,.600,28,18,.643,28,10,.370,27,.509,55,16,.941,17,23,0,192,Gui Santos,17,23,PF,82,4,GSW,7,49
20,27,,5,27,.418,34,25,.481,52,9,.225,40,.370,92,4,.500,8,17,0,196,Kobe Bufkin,6,20,SG,81,7,ATL,10,33
24,19,,2,18,.474,34,28,.571,49,6,.207,29,.436,78,7,.778,9,13,1,214,Jaylen Nowell,6,15,SG,81,4,2TM,7,24
24,16,,0,11,.436,22,18,.563,32,4,.174,23,.400,55,3,1.000,3,9,1,156,Jaylen Nowell,3,13,SG,51,3,MEM,5,14
24,3,,2,7,.565,12,10,.588,17,2,.333,6,.522,23,4,.667,6,4,0,58,Jaylen Nowell,3,2,SG,30,1,DET,2,10
24,13,,2,26,.452,32,20,.500,40,12,.273,44,.381,84,4,.800,5,23,1,268,Onuralp Bitim,6,24,SG,80,3,CHI,10,32
24,54,,9,31,.465,29,21,.457,46,8,.320,25,.408,71,14,.824,17,19,1,316,Ashton Hagans,14,40,PG,80,11,POR,30,45
31,39,,5,64,.427,26,25,.424,59,1,.333,3,.419,62,23,.605,38,43,0,320,Cody Zeller,48,45,C,76,9,NOP,16,112
24,7,,7,49,.508,33,33,.508,65,0,,0,.508,65,9,.290,31,22,5,200,Moses Brown,37,27,C,75,5,POR,11,86
24,16,,1,16,.539,29,18,.514,35,11,.379,29,.453,64,5,.556,9,19,0,149,Jules Bernard,10,14,SG,74,3,WAS,8,26
24,30,,3,22,.382,20,18,.462,39,2,.125,16,.364,55,29,.744,39,24,0,185,Saben Lee,9,13,PG,71,7,PHO,8,31
24,24,,11,39,.567,25,16,.500,32,9,.450,20,.481,52,10,.667,15,26,3,284,Leaky Black,9,19,SF,69,8,CHO,6,48
27,9,,6,19,.568,33,32,.604,53,1,.167,6,.559,59,1,.143,7,6,1,134,Brandon Clarke,13,8,PF,68,5,MEM,3,32
34,16,,3,35,.449,23,8,.308,26,15,.357,42,.338,68,5,.833,6,26,1,216,Markieff Morris,4,12,PF,66,5,DAL,12,39
21,20,,5,23,.408,28,26,.531,49,2,.091,22,.394,71,6,.545,11,30,0,192,Colby Jones,17,29,SG,64,7,SAC,10,40
23,21,,17,53,.725,29,29,.744,39,0,.000,1,.725,40,5,.833,6,19,0,205,Charles Bassey,23,31,C,63,8,SAS,15,76
32,42,,3,24,.461,23,10,.455,22,13,.310,42,.359,64,4,.571,7,26,0,296,Cory Joseph,6,25,PG,63,4,GSW,12,30
24,7,,1,11,.560,27,25,.556,45,2,.400,5,.540,50,7,.538,13,22,0,129,Jeenathan Williams,12,10,SG,63,4,HOU,4,23
24,21,,10,26,.378,22,10,.400,25,12,.245,49,.297,74,5,.556,9,34,1,381,Justin Minaya,30,35,SF,61,9,POR,9,56
22,28,,0,20,.321,20,15,.375,40,5,.167,30,.286,70,14,.933,15,17,1,213,ThÃ©o Maledon,4,21,PG,59,7,2TM,18,24
22,28,,0,19,.326,19,14,.389,36,5,.167,30,.288,66,11,.917,12,13,1,200,ThÃ©o Maledon,4,18,PG,54,7,CHO,15,23
22,0,,0,1,.250,1,1,.250,4,0,,0,.250,4,3,1.000,3,4,0,13,ThÃ©o Maledon,0,3,PG,5,0,PHO,3,1
25,6,,3,18,.490,23,20,.556,36,3,.214,14,.460,50,7,.538,13,23,0,100,Harry Giles,12,15,C,56,2,2TM,6,30
25,6,,3,14,.534,22,19,.576,33,3,.273,11,.500,44,7,.538,13,16,0,81,Harry Giles,12,15,C,54,1,BRK,6,26
25,0,,0,4,.167,1,1,.333,3,0,.000,3,.167,6,0,,0,7,0,19,Harry Giles,0,0,C,2,1,LAL,0,4
24,17,,1,9,.398,20,17,.436,39,3,.200,15,.370,54,11,.647,17,17,0,113,Brandon Williams,4,4,PG,54,1,DAL,7,13
25,6,,6,33,.588,19,10,.526,19,9,.429,21,.475,40,6,.750,8,16,0,186,Micah Potter,10,14,PF,53,4,UTA,5,43
26,27,,1,17,.681,20,11,.647,17,9,.474,19,.556,36,3,.750,4,12,0,142,Jeff Dowtin,3,1,PG,52,7,PHI,5,20
21,12,,0,4,.533,18,5,.455,11,13,.371,35,.391,46,3,.600,5,16,0,84,Terquavion Smith,0,8,PG,52,8,PHI,7,4
38,16,,7,57,.490,18,5,.333,15,13,.371,35,.360,50,3,1.000,3,31,10,486,P.J. Tucker,28,54,PF,52,16,2TM,8,85
38,0,,2,13,.600,2,0,,0,2,.400,5,.400,5,0,,0,3,3,66,P.J. Tucker,1,9,PF,6,3,PHI,2,14
38,16,,5,44,.478,16,5,.333,15,11,.367,30,.356,45,3,1.000,3,28,7,420,P.J. Tucker,27,45,PF,46,13,LAC,6,71
23,6,,1,8,.598,18,5,.455,11,13,.433,30,.439,41,1,.500,2,14,0,81,James Bouknight,1,3,SG,50,1,CHO,2,9
21,8,,5,13,.528,17,13,.500,26,4,.400,10,.472,36,12,.857,14,32,0,91,Josh Minott,4,10,SF,50,5,MIN,2,17
23,7,,7,20,.633,18,16,.727,22,2,.250,8,.600,30,10,.833,12,9,0,152,Darius Bazley,8,3,PF,48,6,2TM,8,28
23,2,,0,1,.000,0,0,.000,1,0,,0,.000,1,0,,0,3,0,10,Darius Bazley,0,0,PF,0,0,PHI,1,1
23,5,,7,19,.655,18,16,.762,21,2,.250,8,.621,29,10,.833,12,6,0,142,Darius Bazley,8,3,PF,48,6,UTA,7,27
20,5,,2,16,.371,18,8,.348,23,10,.256,39,.290,62,2,1.000,2,20,0,171,AJ Griffin,2,6,SF,48,1,ATL,8,18
23,2,,4,26,.586,18,13,.591,22,5,.385,13,.514,35,7,.700,10,7,1,122,MÃ£ozinha Pereira,11,10,SF,48,6,MEM,5,37
22,8,,0,18,.512,18,12,.632,19,6,.273,22,.439,41,5,.833,6,7,1,121,Jahmi'us Ramsey,4,10,SG,47,7,TOR,7,22
24,10,,2,20,.538,20,18,.600,30,2,.222,9,.513,39,4,.800,5,31,0,188,Terry Taylor,17,17,PF,46,5,CHI,7,37
19,10,,3,14,.500,16,15,.714,21,1,.083,12,.485,33,12,.800,15,12,0,141,Sidy Cissoko,8,18,SF,45,7,SAS,3,22
35,6,,2,25,.529,18,18,.563,32,0,.000,2,.529,34,9,.643,14,14,0,71,Boban MarjanoviÄ,7,5,C,45,1,HOU,5,32
21,14,,3,11,.574,14,11,.478,23,3,.750,4,.519,27,13,.765,17,13,0,78,Ryan Rollins,2,8,PG,44,10,2TM,8,13
21,11,,3,9,.560,13,11,.500,22,2,.667,3,.520,25,13,.765,17,10,0,66,Ryan Rollins,2,7,PG,41,8,WAS,7,11
21,3,,0,2,.750,1,0,.000,1,1,1.000,1,.500,2,0,,0,3,0,12,Ryan Rollins,0,1,PG,3,2,MIL,1,2
26,26,,2,36,.380,17,13,.351,37,4,.308,13,.340,50,5,.455,11,9,0,150,DeJon Jarreau,8,14,SG,43,6,MEM,9,44
27,10,,0,13,.717,15,2,.667,3,13,.481,27,.500,30,0,,0,17,0,108,Dylan Windler,3,6,SF,43,2,3TM,2,16
27,1,,0,1,.750,1,0,,0,1,.500,2,.500,2,0,,0,3,0,7,Dylan Windler,0,1,SF,3,0,NYK,0,1
27,6,,0,3,.667,4,0,.000,1,4,.500,8,.444,9,0,,0,8,0,28,Dylan Windler,0,2,SF,12,0,LAL,0,3
27,3,,0,9,.737,10,2,1.000,2,8,.471,17,.526,19,0,,0,6,0,73,Dylan Windler,3,3,SF,28,2,ATL,2,12
25,5,,1,11,.446,15,4,.286,14,11,.344,32,.326,46,1,.500,2,10,0,104,Armoni Brooks,7,3,PG,42,1,BRK,3,18
24,21,,0,13,.557,15,6,.600,10,9,.360,25,.429,35,3,.750,4,27,0,122,Jalen Pickett,1,13,SG,42,4,DEN,9,14
26,25,,3,16,.361,17,12,.324,37,5,.294,17,.315,54,3,.750,4,7,0,161,Zavier Simpson,4,11,PG,42,7,MEM,10,20
24,5,,1,6,.526,15,5,.625,8,10,.333,30,.395,38,2,1.000,2,18,0,87,Cole Swider,1,4,SF,42,1,MIA,8,7
20,10,,2,13,.408,15,5,.313,16,10,.303,33,.306,49,1,.250,4,15,0,133,Emoni Bates,1,5,SF,41,1,CLE,8,14
30,9,,1,17,.463,18,16,.571,28,2,.154,13,.439,41,3,.750,4,11,0,125,T.J. Warren,5,11,SF,41,4,MIN,4,22
26,5,,7,27,.654,17,17,.654,26,0,,0,.654,26,7,.778,9,6,0,119,Robert Williams,11,17,C,41,7,POR,7,38
26,18,,5,17,.408,14,11,.524,21,3,.176,17,.368,38,9,.750,12,14,0,165,Trevelin Queen,3,15,SG,40,7,ORL,7,20
32,10,,2,10,.487,14,4,.444,9,10,.333,30,.359,39,1,.500,2,16,0,170,Joe Harris,3,19,SG,39,3,DET,4,13
30,8,,5,23,.545,14,6,.600,10,8,.348,23,.424,33,3,1.000,3,15,1,174,Otto Porter Jr.,6,19,SF,39,5,TOR,2,29
26,14,,3,8,.561,15,8,.500,16,7,.412,17,.455,33,2,1.000,2,9,0,131,Dru Smith,6,12,SG,39,9,MIA,5,14
25,4,,7,24,.680,17,17,.708,24,0,.000,1,.680,25,3,.750,4,11,2,121,Marques Bolden,10,10,C,37,3,2TM,3,34
25,0,,0,2,,0,0,,0,0,,0,,0,0,,0,2,0,3,Marques Bolden,0,1,C,0,0,MIL,0,2
25,4,,7,22,.680,17,17,.708,24,0,.000,1,.680,25,3,.750,4,9,2,118,Marques Bolden,10,9,C,37,3,CHO,3,32
21,0,,0,17,.519,14,14,.519,27,0,,0,.519,27,8,.667,12,9,0,66,Adama Sanogo,19,5,PF,36,1,CHI,5,36
24,3,,6,21,.696,16,16,.696,23,0,,0,.696,23,3,.231,13,16,0,113,Udoka Azubuike,11,17,C,35,1,PHO,4,32
21,13,,20,31,.636,14,14,.636,22,0,,0,.636,22,6,.500,12,22,1,226,Ibou Badji,20,46,C,34,3,POR,15,51
24,3,,1,7,.448,9,1,.250,4,8,.320,25,.310,29,8,.800,10,10,0,84,Buddy Boeheim,3,5,SF,34,0,DET,0,10
20,8,,2,11,.244,10,8,.267,30,2,.133,15,.222,45,12,.600,20,21,0,109,Jalen Hood-Schifino,2,13,SG,34,3,LAL,9,13
24,2,,7,26,.632,11,9,.692,13,2,.333,6,.579,19,10,.667,15,15,0,98,Olivier Sarr,10,18,C,34,0,OKC,3,36
27,21,,0,5,.337,15,12,.571,21,3,.107,28,.306,49,1,.500,2,11,0,218,Gabe Vincent,4,19,PG,34,9,LAL,5,9
38,11,,7,25,.432,15,13,.481,27,2,.200,10,.405,37,2,1.000,2,20,1,204,Taj Gibson,12,31,PF,34,3,2TM,5,37
38,9,,6,18,.304,7,7,.412,17,0,.000,6,.304,23,2,1.000,2,16,1,165,Taj Gibson,10,28,PF,16,2,NYK,5,28
38,2,,1,7,.643,8,6,.600,10,2,.500,4,.571,14,0,,0,4,0,39,Taj Gibson,2,3,PF,18,1,DET,0,9
24,10,,2,15,.558,11,4,.333,12,7,.500,14,.423,26,4,.800,5,15,0,75,Nate Hinton,7,11,SG,33,3,HOU,3,22
25,9,,14,36,.429,12,12,.429,28,0,,0,.429,28,9,.750,12,25,0,307,Nathan Mensah,29,64,C,33,6,CHO,14,65
29,21,,3,10,.348,15,13,.448,29,2,.118,17,.326,46,1,.500,2,14,1,119,Xavier Moon,8,8,SG,33,3,LAC,5,18
31,17,,4,6,.533,16,16,.552,29,0,.000,1,.533,30,0,.000,2,34,0,155,Thanasis Antetokounmpo,7,24,PF,32,7,MIL,14,13
23,4,,3,7,.426,12,7,.500,14,5,.250,20,.353,34,3,1.000,3,8,0,113,Matthew Hurt,9,8,PF,32,3,MEM,2,16
21,3,,1,4,.476,8,4,.364,11,4,.400,10,.381,21,11,.917,12,5,0,61,Keon Johnson,3,5,SG,31,3,BRK,5,7
26,5,,3,5,.364,11,9,.563,16,2,.118,17,.333,33,7,.636,11,22,0,81,Jerome Robinson,1,5,SG,31,1,GSW,2,6
22,4,,1,9,.526,10,10,.526,19,0,,0,.526,19,9,.643,14,11,0,64,Moussa DiabatÃ©,15,4,C,29,5,LAC,2,24
20,6,,2,6,.450,10,3,.600,5,7,.280,25,.333,30,2,.500,4,18,0,67,Jett Howard,1,4,SF,29,2,ORL,3,7
20,8,,1,15,.700,13,11,.733,15,2,.400,5,.650,20,1,.500,2,17,0,52,Leonard Miller,5,5,SF,29,2,MIN,1,20
21,6,,0,2,.500,9,3,.429,7,6,.353,17,.375,24,3,.500,6,15,0,50,Daishen Nix,1,2,PG,27,5,MIN,5,3
24,5,,0,8,.639,10,7,.583,12,3,.500,6,.556,18,3,1.000,3,4,0,51,David Duke Jr.,2,4,SG,26,2,SAS,3,10
25,5,,18,11,.289,11,11,.314,35,0,.000,3,.289,38,4,.444,9,11,0,120,Mouhamadou Gueye,12,15,PF,26,3,TOR,12,23
20,5,,0,18,.523,11,10,.588,17,1,.200,5,.500,22,3,.750,4,21,0,90,Chris Livingston,3,15,SF,26,2,MIL,5,21
26,7,,0,14,.500,10,4,.400,10,6,.375,16,.385,26,0,.000,2,23,0,84,Admiral Schofield,3,9,PF,26,1,ORL,5,17
24,2,,1,8,.500,10,10,.500,20,0,,0,.500,20,6,.750,8,8,0,42,Oscar Tshiebwe,8,3,PF,26,2,IND,0,16
23,3,,0,6,.563,9,9,.563,16,0,,0,.563,16,6,1.000,6,16,0,59,Colin Castleton,6,11,C,24,2,LAL,3,12
21,4,,4,12,.413,8,5,.357,14,3,.333,9,.348,23,5,.833,6,6,0,73,Mouhamed Gueye,10,13,PF,24,5,ATL,1,22
19,7,,0,3,.354,8,7,.438,16,1,.125,8,.333,24,6,.857,7,10,0,65,Amari Bailey,6,2,PG,23,3,CHO,4,9
24,6,,1,5,.676,10,7,.700,10,3,.429,7,.588,17,0,,0,3,0,39,RaiQuan Gray,2,0,PF,23,1,SAS,1,7
25,2,,3,9,.700,9,6,1.000,6,3,.333,9,.600,15,2,1.000,2,20,0,49,Jay Huff,2,9,C,23,2,DEN,1,11
24,6,,0,7,.479,10,7,.500,14,3,.300,10,.417,24,0,.000,1,10,0,72,Isaiah Mobley,3,6,PF,23,2,CLE,2,10
29,1,,1,11,.438,7,0,.000,4,7,.350,20,.292,24,2,1.000,2,11,0,62,Ish Wainright,3,8,SF,23,4,2TM,2,14
29,0,,1,9,.500,6,0,.000,2,6,.375,16,.333,18,2,1.000,2,7,0,46,Ish Wainright,0,4,SF,20,2,POR,1,9
29,1,,0,2,.250,1,0,.000,2,1,.250,4,.167,6,0,,0,4,0,16,Ish Wainright,3,4,SF,3,2,PHO,1,5
24,4,,1,8,.553,10,9,.818,11,1,.125,8,.526,19,1,.333,3,4,0,30,Dexter Dennis,1,1,SG,22,0,DAL,3,9
26,9,,1,15,.471,7,5,.417,12,2,.400,5,.412,17,6,.750,8,20,0,60,Braxton Key,3,5,SF,22,2,DEN,1,18
20,5,,0,2,.533,8,8,.615,13,0,.000,2,.533,15,5,.625,8,15,0,63,Kendall Brown,3,9,SG,21,0,IND,2,5
24,11,,0,16,.375,10,9,.474,19,1,.111,9,.357,28,0,,0,9,0,95,Jamaree Bouyea,3,10,PG,21,1,2TM,9,19
24,8,,0,8,.238,5,5,.385,13,0,.000,8,.238,21,0,,0,6,0,57,Jamaree Bouyea,2,3,PG,10,0,POR,8,10
24,3,,0,8,.786,5,4,.667,6,1,1.000,1,.714,7,0,,0,3,0,38,Jamaree Bouyea,1,7,PG,11,1,SAS,1,9
25,3,,2,10,.643,9,9,.750,12,0,.000,2,.643,14,2,1.000,2,14,0,60,Jermaine Samuels,3,5,SF,20,1,HOU,0,13
26,12,,2,6,.476,9,7,.538,13,2,.250,8,.429,21,0,,0,4,0,67,Kobi Simmons,1,5,PG,20,6,TOR,1,7
23,2,,0,8,.500,8,4,.667,6,4,.286,14,.400,20,0,,0,18,0,48,Hunter Tyson,1,10,PF,20,1,DEN,2,9
25,2,,4,23,.279,9,8,.276,29,1,.200,5,.265,34,0,.000,2,7,2,107,Malik Williams,15,15,C,19,3,TOR,3,38
35,4,,3,2,.421,7,5,.455,11,2,.250,8,.368,19,2,1.000,2,16,2,65,Robin Lopez,3,7,C,18,1,MIL,2,5
25,5,,0,4,.447,8,7,.583,12,1,.143,7,.421,19,1,.500,2,4,0,40,Taze Moore,4,4,SG,18,2,POR,3,8
22,6,,1,12,.500,9,9,.750,12,0,.000,6,.500,18,0,,0,25,0,75,Wendell Moore Jr.,0,5,SG,18,5,MIN,4,12
26,3,,2,18,.386,8,7,.438,16,1,.167,6,.364,22,0,.000,5,5,0,81,Wenyen Gabriel,7,10,PF,17,2,MEM,8,25
21,10,,1,8,.542,5,2,.400,5,3,.429,7,.417,12,3,.750,4,8,0,39,JD Davison,2,4,SG,16,1,BOS,2,10
22,4,,4,6,.500,5,4,.500,8,1,.333,3,.455,11,4,.444,9,6,0,40,Greg Brown III,3,5,PF,15,0,DAL,4,9
19,5,,1,15,.467,6,4,.667,6,2,.222,9,.400,15,1,.500,2,9,1,83,Jordan Walsh,5,11,SF,15,5,BOS,3,20
20,0,,0,1,.433,6,5,.500,10,1,.200,5,.400,15,2,1.000,2,6,0,40,Alex Fudge,4,2,SF,15,3,2TM,2,5
20,0,,0,0,.167,1,1,.250,4,0,.000,2,.167,6,2,1.000,2,4,0,14,Alex Fudge,2,1,SF,4,0,LAL,1,2
20,0,,0,1,.611,5,4,.667,6,1,.333,3,.556,9,0,,0,2,0,26,Alex Fudge,2,1,SF,11,3,DAL,1,3
25,5,,1,0,.433,5,2,.667,3,3,.250,12,.333,15,1,.500,2,7,0,41,D'Moi Hodge,0,4,SG,14,1,LAL,1,0
26,5,,1,5,.412,6,4,.571,7,2,.200,10,.353,17,0,.000,2,17,0,46,DaQuan Jeffries,0,2,SG,14,0,NYK,3,5
23,0,,0,6,.324,4,1,.250,4,3,.231,13,.235,17,3,.750,4,9,0,52,Seth Lundy,1,6,SF,14,0,ATL,1,7
23,5,,1,6,.346,4,3,.273,11,1,.500,2,.308,13,5,.833,6,6,0,55,Dereon Seabron,1,4,SG,14,2,NOP,0,7
22,5,,0,4,.350,6,4,.286,14,2,.333,6,.300,20,0,,0,11,0,56,TyTy Washington Jr.,1,1,PG,14,3,MIL,2,5
24,5,,0,13,.261,6,6,.375,16,0,.000,7,.261,23,1,.500,2,5,0,125,Timmy Allen,4,18,SF,13,4,MEM,2,17
24,0,,0,2,.611,5,4,.571,7,1,.500,2,.556,9,2,1.000,2,8,0,28,Jordan Miller,3,2,SF,13,0,LAC,1,5
23,3,,1,4,.611,5,4,.800,5,1,.250,4,.556,9,2,1.000,2,9,0,38,Jacob Toppin,3,3,SF,13,0,NYK,1,7
27,2,,1,3,.667,4,4,.800,5,0,.000,1,.667,6,4,.667,6,6,0,24,Mamadi Diakite,1,2,PF,12,1,2TM,1,4
27,2,,1,2,.800,4,4,.800,5,0,,0,.800,5,4,.667,6,3,0,16,Mamadi Diakite,1,1,PF,12,0,SAS,0,3
27,0,,0,1,.000,0,0,,0,0,.000,1,.000,1,0,,0,3,0,8,Mamadi Diakite,0,1,PF,0,1,NYK,1,1
25,2,,0,2,.714,4,2,.500,4,2,.667,3,.571,7,2,1.000,2,6,0,22,Jordan Ford,0,0,PG,12,0,SAC,1,2
24,16,,1,11,.316,6,6,.375,16,0,.000,3,.316,19,0,,0,7,0,71,Jason Preston,6,3,PG,12,2,UTA,2,17
23,3,,0,2,.438,3,2,.500,4,1,.250,4,.375,8,4,.800,5,4,0,36,D.J. Carton,2,3,SG,11,1,TOR,1,4
23,4,,1,3,.500,4,2,.500,4,2,.333,6,.400,10,1,.500,2,4,0,30,Henri Drell,1,6,SF,11,2,CHI,2,4
23,4,,0,6,.344,5,4,.308,13,1,.333,3,.313,16,0,,0,9,0,66,Keyontae Johnson,4,5,SF,11,1,OKC,4,10
21,6,,1,2,.214,4,3,.250,12,1,.111,9,.190,21,2,.667,3,34,0,103,Maxwell Lewis,2,5,SF,11,2,LAL,10,4
24,1,,0,1,.917,4,1,1.000,1,3,.600,5,.667,6,0,,0,3,0,23,Drew Peterson,0,1,PF,11,2,BOS,1,1
22,8,,0,4,.321,4,3,.500,6,1,.125,8,.286,14,1,.500,2,8,2,76,R.J. Hampton,2,8,PG,10,0,MIA,3,6
27,2,,2,1,.833,4,2,.500,4,2,1.000,2,.667,6,0,,0,2,0,15,D.J. Wilson,1,1,PF,10,0,PHI,0,2
36,8,,1,3,.300,3,3,.375,8,0,.000,2,.300,10,2,1.000,2,9,0,47,James Johnson,1,9,PF,8,5,IND,5,4
24,2,,1,6,.667,4,4,1.000,4,0,.000,2,.667,6,0,,0,12,0,37,Jalen Slawson,1,8,SF,8,1,SAC,2,7
34,3,,0,0,.400,3,1,.167,6,2,.500,4,.300,10,0,,0,6,0,19,Isaiah Thomas,0,0,PG,8,0,PHO,0,0
25,5,,0,4,.375,2,0,.000,1,2,.286,7,.250,8,1,.500,2,5,0,28,Mason Jones,1,3,SG,7,1,SAC,2,5
30,4,,1,10,.292,3,2,.250,8,1,.250,4,.250,12,0,,0,11,0,53,Juan Toscano-Anderson,4,11,SF,7,1,SAC,2,14
26,0,,2,1,.300,2,0,.000,3,2,.286,7,.200,10,0,,0,8,0,37,Charlie Brown Jr.,1,5,SG,6,0,NYK,2,2
26,1,,1,8,.188,2,0,.000,6,2,.200,10,.125,16,0,,0,4,0,64,Jack White,4,3,SF,6,4,MEM,2,12
25,0,,0,0,.400,2,2,.667,3,0,.000,2,.400,5,2,1.000,2,3,0,8,Lindell Wigginton,0,1,PG,6,0,MIL,1,0
25,4,,0,5,.167,1,0,.000,1,1,.125,8,.111,9,2,1.000,2,5,0,43,Frank Ntilikina,1,4,PG,5,0,CHO,1,6
24,0,,1,1,.250,2,2,.500,4,0,.000,4,.250,8,1,1.000,1,7,0,16,Alondes Williams,0,2,SG,5,0,MIA,2,1
24,0,,0,1,.400,2,2,.500,4,0,.000,1,.400,5,0,,0,1,0,3,Izaiah Brockington,1,0,PG,4,0,NOP,0,2
26,1,,0,2,.667,2,2,.667,3,0,,0,.667,3,0,,0,2,0,6,Kevon Harris,0,3,SG,4,0,ORL,1,2
26,3,,0,0,.500,2,2,.667,3,0,.000,1,.500,4,0,,0,2,0,15,Ty Jerome,1,2,SG,4,0,CLE,1,1
23,1,,2,5,.167,1,1,1.000,1,0,.000,5,.167,6,2,1.000,2,8,0,23,E.J. Liddell,0,2,PF,4,2,NOP,2,5
27,5,,0,2,.500,2,2,1.000,2,0,.000,2,.500,4,0,,0,6,0,26,Pat Spencer,2,1,PG,4,0,GSW,1,4
24,4,,0,0,.214,1,0,.000,1,1,.167,6,.143,7,0,,0,2,0,14,Adam Flagler,0,0,SG,3,0,OKC,0,0
21,1,,3,4,.167,1,1,.200,5,0,.000,1,.167,6,1,.500,2,6,0,18,Usman Garuba,3,2,PF,3,1,GSW,2,7
19,3,,1,4,.200,1,1,.500,2,0,.000,3,.200,5,1,.500,2,2,0,24,Dariq Whitehead,0,0,SF,3,0,BRK,0,4
23,0,,0,3,.250,1,0,.000,5,1,1.000,1,.167,6,0,.000,2,8,0,27,Pete Nance,0,2,PF,3,1,CLE,1,3
23,0,,0,1,.500,1,1,.500,2,0,,0,.500,2,1,.500,2,3,0,10,Filip PetruÅ¡ev,0,1,C,3,0,2TM,0,1
23,0,,0,1,,0,0,,0,0,,0,,0,0,,0,1,0,3,Filip PetruÅ¡ev,0,0,C,0,0,PHI,0,1
23,0,,0,0,.500,1,1,.500,2,0,,0,.500,2,1,.500,2,2,0,7,Filip PetruÅ¡ev,0,1,C,3,0,SAC,0,0
25,1,,0,0,.500,1,1,.500,2,0,,0,.500,2,0,,0,2,0,5,Hamidou Diallo,2,1,SG,2,2,WAS,1,2
30,0,,1,2,.500,1,1,.500,2,0,,0,.500,2,0,,0,3,0,6,Shaquille Harrison,0,0,SG,2,0,MEM,0,2
25,2,,0,4,.000,0,0,.000,1,0,,0,.000,1,2,1.000,2,3,0,11,Quenton Jackson,0,1,PG,2,1,IND,0,4
24,2,,0,0,.000,0,0,.000,1,0,,0,.000,1,2,1.000,2,1,0,4,Markquis Nowell,2,0,SG,2,1,TOR,0,2
21,0,,1,0,.333,1,1,.500,2,0,.000,1,.333,3,0,,0,2,0,10,Joshua Primo,1,0,SG,2,0,LAC,4,1
23,0,,0,0,.333,1,1,.500,2,0,.000,1,.333,3,0,,0,1,0,4,Isaiah Wong,0,0,SG,2,0,IND,0,0
29,4,,0,8,.000,0,0,,0,0,.000,6,.000,6,0,,0,20,0,45,Ryan Arcidiacono,0,5,PG,0,2,NYK,2,8
22,0,,0,0,,0,0,,0,0,,0,,0,0,,0,1,0,3,Malcolm Cazalon,0,0,SG,0,0,DET,0,0
24,0,,0,0,.000,0,0,.000,1,0,,0,.000,1,0,,0,1,0,3,Jalen Crutcher,0,0,PG,0,0,NOP,0,0
24,0,,1,0,.000,0,0,.000,1,0,.000,3,.000,4,0,,0,5,0,13,Andrew Funk,0,0,SG,0,1,CHI,0,0
27,0,,0,1,.000,0,0,.000,2,0,.000,2,.000,4,0,,0,1,0,7,Kaiser Gates,0,0,SF,0,0,NOP,0,1
36,1,,0,2,.000,0,0,.000,1,0,.000,1,.000,2,0,,0,2,0,18,Danny Green,0,1,SG,0,1,PHI,0,2
23,1,,0,0,,0,0,,0,0,,0,,0,0,,0,1,0,4,Ron Harper Jr.,0,2,PF,0,0,TOR,0,0
28,0,,0,0,,0,0,,0,0,,0,,0,0,,0,2,0,1,Justin Jackson,0,0,SF,0,0,MIN,0,0
25,0,,0,0,.000,0,0,.000,1,0,,0,.000,1,0,,0,2,0,2,Dmytro Skapintsev,0,0,C,0,0,NYK,0,0
24,0,,0,0,,0,0,,0,0,,0,,0,0,,0,1,0,1,Javonte Smart,0,0,PG,0,0,PHI,0,0
,,,,,.547,,,.545,,,.366,,.474,,,.784,,,,,League Average,,,,,,,,
24,178,,8,192,.514,225,157,.536,293,68,.322,211,.446,504,117,.765,153,22,22,900,Luka DonÄiÄ,16,56,PG,635,41,DAL,90,208
31,113,,7,59,.534,186,133,.508,262,53,.390,136,.467,398,62,.849,73,22,22,879,Kyrie Irving,22,62,SG,487,23,DAL,51,81
25,119,,13,167,.480,159,120,.513,234,39,.283,138,.427,372,118,.861,137,19,19,768,Jayson Tatum,17,54,PF,475,20,BOS,50,184
27,62,,12,91,.569,175,139,.607,229,36,.327,110,.516,339,68,.660,103,19,19,707,Jaylen Brown,22,51,SF,454,23,BOS,51,113
22,104,Finals MVP-1,9,94,.552,156,110,.526,209,46,.400,115,.481,324,83,.814,102,16,16,649,Anthony Edwards,18,37,SG,441,24,MIN,52,112
27,97,,2,35,.482,151,125,.488,256,26,.310,84,.444,340,93,.775,120,13,13,518,Jalen Brunson,8,26,PG,421,10,NYK,35,43
29,64,,7,86,.566,157,143,.588,243,14,.298,47,.541,290,39,.619,63,17,17,603,Pascal Siakam,42,48,PF,367,13,IND,19,128
28,104,,8,118,.574,133,119,.623,191,14,.264,53,.545,244,64,.901,71,12,12,482,Nikola JokiÄ,43,32,C,344,17,DEN,40,161
29,77,,23,62,.587,109,44,.550,80,65,.404,161,.452,241,35,.921,38,19,19,676,Derrick White,19,44,SG,318,18,BOS,16,81
28,42,,3,109,.530,108,78,.523,149,30,.361,83,.466,232,59,.855,69,16,16,522,Karl-Anthony Towns,35,55,PF,305,12,MIN,27,144
25,64,,17,64,.531,111,95,.508,187,16,.432,37,.496,224,64,.790,81,10,10,399,Shai Gilgeous-Alexander,8,31,PG,302,13,OKC,22,72
27,47,,3,48,.540,107,78,.545,143,29,.354,82,.476,225,53,.815,65,10,10,382,Donovan Mitchell,6,29,SG,296,13,CLE,28,54
27,36,,25,87,.612,106,67,.563,119,39,.453,86,.517,205,38,.760,50,17,17,550,Myles Turner,26,44,C,289,8,IND,33,113
25,31,,17,112,.528,100,53,.535,99,47,.348,135,.427,234,39,.709,55,22,22,785,P.J. Washington,33,67,PF,286,16,DAL,32,145
23,123,,10,60,.612,105,52,.693,75,53,.379,140,.488,215,17,.850,20,15,15,522,Tyrese Haliburton,12,14,PG,280,19,IND,31,72
24,94,,4,42,.640,102,73,.598,122,29,.483,60,.560,182,20,.769,26,17,17,554,Andrew Nembhard,14,56,PG,253,6,IND,23,56
33,83,,12,79,.593,97,62,.585,106,35,.402,87,.503,193,21,.955,22,19,19,720,Jrue Holiday,37,40,PG,250,21,BOS,29,116
26,67,,6,43,.448,100,77,.438,176,23,.315,73,.402,249,24,.923,26,12,12,462,Jamal Murray,9,28,PG,247,10,DEN,31,52
27,34,,12,39,.537,80,35,.412,85,45,.425,106,.419,191,26,.867,30,13,13,466,Donte DiVincenzo,13,29,SG,231,16,NYK,16,52
26,27,,21,43,.556,77,53,.558,95,24,.369,65,.481,160,22,.733,30,22,22,647,Derrick Jones Jr.,33,54,SF,200,11,DAL,18,76
31,86,,2,41,.505,90,83,.522,159,7,.269,26,.486,185,13,.867,15,17,0,348,T.J. McConnell,11,26,PG,200,15,IND,21,52
29,34,,9,46,.492,59,46,.489,94,13,.333,39,.444,133,67,.859,78,6,6,248,Joel Embiid,19,20,C,198,7,PHI,25,65
25,15,,33,80,.634,78,78,.634,123,0,,0,.634,123,41,.631,65,22,22,445,Daniel Gafford,42,38,PF,197,6,DAL,19,122
23,18,,18,33,.600,72,48,.571,84,24,.429,56,.514,140,27,.771,35,16,16,537,Jaden McDaniels,28,54,SF,195,14,MIN,17,61
22,28,,26,81,.572,81,76,.594,128,5,.278,18,.555,146,25,.694,36,12,12,422,Evan Mobley,30,34,PF,192,10,CLE,22,111
21,28,,4,46,.510,68,52,.477,109,16,.400,40,.456,149,37,.755,49,7,7,262,Paolo Banchero,14,14,PF,189,8,ORL,32,60
28,59,,10,113,.513,66,44,.484,91,22,.373,59,.440,150,35,.729,48,13,13,548,Josh Hart,37,41,SF,189,13,NYK,34,150
25,13,,10,74,.579,68,35,.538,65,33,.407,81,.466,146,20,.769,26,12,12,443,Michael Porter Jr.,8,27,SF,189,11,DEN,18,82
24,69,,2,42,.500,73,48,.480,100,25,.352,71,.427,171,17,.810,21,12,12,432,Darius Garland,1,33,PG,188,13,CLE,27,43
22,54,,5,55,.516,75,60,.496,121,15,.385,39,.469,160,22,.815,27,10,10,377,Jalen Williams,13,21,PF,187,17,OKC,19,68
25,29,,6,65,.615,73,53,.671,79,20,.357,56,.541,135,19,.760,25,17,0,343,Obi Toppin,10,21,PF,185,6,IND,14,75
31,24,,15,107,.615,64,64,.615,104,0,,0,.615,104,53,.671,79,15,15,512,Rudy Gobert,40,55,C,181,14,MIN,23,147
23,41,,2,30,.558,66,44,.530,83,22,.400,55,.478,138,25,.893,28,6,6,267,Tyrese Maxey,1,16,PG,179,5,PHI,13,31
24,37,,9,65,.511,61,39,.629,62,22,.278,79,.433,141,34,.919,37,17,17,559,Aaron Nesmith,19,66,SF,178,11,IND,23,84
24,16,,12,50,.546,65,40,.548,73,25,.362,69,.458,142,22,.710,31,16,0,361,Naz Reid,9,32,C,177,8,MIN,14,59
36,86,,3,48,.531,62,32,.464,69,30,.395,76,.428,145,20,.714,28,15,15,474,Mike Conley,10,38,PG,174,21,MIN,20,58
37,40,,16,98,.605,66,31,.721,43,35,.368,95,.478,138,7,.636,11,19,15,575,Al Horford,35,28,C,174,15,BOS,12,133
28,53,,7,51,.631,69,58,.637,91,11,.407,27,.585,118,23,.821,28,12,12,445,Aaron Gordon,36,28,PF,172,10,DEN,18,87
19,27,,20,99,.679,64,63,.670,94,1,1.000,1,.674,95,36,.590,61,21,0,462,Dereck Lively II,57,48,C,165,9,DAL,21,156
21,21,,25,58,.550,59,46,.667,69,13,.260,50,.496,119,25,.758,33,10,10,345,Chet Holmgren,14,26,C,156,7,OKC,19,72
32,28,,1,43,.531,55,44,.530,83,11,.355,31,.482,114,27,.900,30,6,6,230,Khris Middleton,12,25,SF,148,3,MIL,14,55
23,25,,2,22,.536,54,29,.518,56,25,.368,68,.435,124,10,.833,12,13,2,347,Miles McBride,7,30,PG,143,7,NYK,11,29
30,20,,8,63,.634,59,59,.670,88,0,.000,5,.634,93,21,.808,26,5,5,208,Anthony Davis,15,19,C,139,2,LAL,11,78
39,44,,5,30,.616,56,46,.630,73,10,.385,26,.566,99,17,.739,23,5,5,204,LeBron James,4,11,PF,139,12,LAL,19,34
26,10,,9,47,.577,56,40,.556,72,16,.410,39,.505,111,8,.615,13,9,9,324,OG Anunoby,7,15,SF,136,8,NYK,10,54
22,31,,9,38,.451,42,33,.478,69,9,.265,34,.408,103,39,.886,44,7,7,259,Franz Wagner,10,20,SF,132,5,ORL,9,48
34,48,,6,24,.551,40,22,.524,42,18,.383,47,.449,89,29,.906,32,6,6,242,James Harden,3,13,PG,127,6,LAC,14,27
33,20,,0,11,.543,34,14,.424,33,20,.417,48,.420,81,37,.974,38,4,4,156,Damian Lillard,2,8,PG,125,4,MIL,9,13
26,40,,0,23,.529,44,21,.467,45,23,.383,60,.419,105,11,.917,12,19,0,355,Payton Pritchard,14,22,PG,122,4,BOS,14,37
33,29,,3,38,.505,39,21,.457,46,18,.367,49,.411,95,21,.840,25,6,6,222,Paul George,3,22,PF,117,7,LAC,14,41
25,37,,7,23,.473,41,17,.548,31,24,.296,81,.366,112,10,1.000,10,16,1,378,Nickeil Alexander-Walker,5,24,SG,116,10,MIN,15,28
27,35,,0,56,.529,42,17,.548,31,25,.347,72,.408,103,5,1.000,5,12,12,434,Max Strus,8,41,SF,114,9,CLE,15,64
26,19,,0,36,.505,48,46,.529,87,2,.200,10,.495,97,15,.714,21,5,5,192,Bam Adebayo,11,15,C,113,2,MIA,8,47
29,25,,6,32,.461,44,38,.551,69,6,.182,33,.431,102,17,.654,26,11,1,278,Caris LeVert,8,14,SG,111,9,CLE,14,40
27,24,,1,12,.546,32,25,.556,45,7,.350,20,.492,65,39,.951,41,4,4,166,Devin Booker,1,18,PG,110,7,PHO,11,13
25,46,,12,53,.599,45,44,.595,74,1,.500,2,.592,76,19,.864,22,13,13,388,Isaiah Hartenstein,49,41,C,110,4,NYK,19,102
23,23,,3,35,.559,36,13,.500,26,23,.390,59,.424,85,14,.737,19,22,0,399,Josh Green,21,29,SG,109,17,DAL,7,56
24,20,,2,27,.500,33,8,.296,27,25,.391,64,.363,91,16,.842,19,10,10,350,Luguentz Dort,19,42,SF,107,13,OKC,11,46
35,13,,6,25,.590,37,32,.582,55,5,.417,12,.552,67,28,.824,34,4,4,168,Kevin Durant,1,8,PF,107,2,PHO,10,26
35,11,,8,15,.653,44,34,.654,52,10,.435,23,.587,75,8,.533,15,6,6,200,Brook Lopez,11,10,C,106,0,MIL,9,26
26,11,,3,33,.589,36,9,.692,13,27,.380,71,.429,84,4,1.000,4,19,0,283,Sam Hauser,8,20,SF,103,5,BOS,3,41
22,23,,3,25,.488,33,19,.559,34,14,.292,48,.402,82,23,.767,30,7,7,232,Jalen Suggs,11,18,SG,103,9,ORL,20,36
28,6,,1,52,.500,44,41,.519,79,3,.250,12,.484,91,8,.615,13,6,6,187,Bobby Portis,16,13,PF,99,3,MIL,9,68
30,31,,5,30,.500,34,16,.516,31,18,.327,55,.395,86,11,1.000,11,12,12,420,Kentavious Caldwell-Pope,5,37,SG,97,17,DEN,10,35
26,6,,3,38,.600,42,42,.600,70,0,,0,.600,70,13,.650,20,6,6,192,Ivica Zubac,18,21,C,97,5,LAC,8,56
32,6,,1,16,.620,25,13,.591,22,12,.429,28,.500,50,27,.844,32,6,0,121,Alec Burks,4,6,SG,89,1,NYK,0,20
22,17,,1,41,.570,31,12,.571,21,19,.380,50,.437,71,7,.778,9,17,2,335,Ben Sheppard,10,32,SG,88,8,IND,11,51
21,21,,4,29,.533,34,22,.537,41,12,.353,34,.453,75,7,.875,8,10,8,181,Josh Giddey,7,9,SG,87,2,OKC,12,36
28,8,,11,27,.550,28,18,.581,31,10,.345,29,.467,60,20,.909,22,7,4,165,Kristaps PorziÅÄ£is,4,15,C,86,5,BOS,5,31
24,27,,0,18,.481,30,15,.429,35,15,.349,43,.385,78,9,.900,10,5,5,185,Tyler Herro,0,10,SG,84,2,MIA,14,18
25,18,,3,14,.532,30,23,.622,37,7,.269,26,.476,63,17,.895,19,5,5,174,Austin Reaves,5,8,SG,84,7,LAL,4,19
21,17,,0,13,.507,29,18,.439,41,11,.407,27,.426,68,11,.733,15,19,0,129,Jaden Hardy,2,13,SG,80,3,DAL,7,15
28,10,,7,15,.555,31,22,.537,41,9,.391,23,.484,64,8,.727,11,6,6,224,Kelly Oubre Jr.,9,24,SF,79,11,PHI,8,24
30,2,,0,14,.533,26,13,.406,32,13,.448,29,.426,61,12,.800,15,6,0,179,Norman Powell,3,20,SG,77,3,LAC,7,17
32,19,,3,17,.466,31,24,.533,45,7,.241,29,.419,74,2,1.000,2,4,4,148,CJ McCollum,2,14,PG,71,7,NOP,16,19
27,21,,1,13,.479,28,14,.483,29,14,.318,44,.384,73,1,.500,2,5,5,185,D'Angelo Russell,1,6,PG,71,4,LAL,9,14
25,5,,4,40,.676,25,25,.676,37,0,,0,.676,37,18,.692,26,4,4,127,Jarrett Allen,15,8,C,68,5,CLE,5,55
30,18,,1,5,.525,26,16,.444,36,10,.435,23,.441,59,4,.800,5,4,4,154,Bradley Beal,6,15,SG,66,3,PHO,13,11
23,13,,4,16,.421,25,16,.457,35,9,.257,35,.357,70,7,.778,9,12,7,263,Isaac Okoro,5,30,SF,66,11,CLE,11,21
30,38,,5,22,.474,26,24,.490,49,2,.250,8,.456,57,10,.833,12,15,1,231,Kyle Anderson,18,26,PF,64,10,MIN,10,40
24,10,,0,18,.593,24,8,.533,15,16,.410,39,.444,54,0,,0,10,2,173,Isaiah Joe,4,10,SG,64,5,OKC,5,22
25,10,,3,23,.553,23,17,.630,27,6,.300,20,.489,47,10,.909,11,10,0,157,Aaron Wiggins,9,8,SG,62,6,OKC,9,32
22,9,,5,23,.463,23,19,.528,36,4,.222,18,.426,54,11,.688,16,12,0,204,Christian Braun,9,18,SG,61,2,DEN,1,32
31,5,,1,23,.491,22,9,.429,21,13,.351,37,.379,58,4,.500,8,14,0,178,Tim Hardaway Jr.,2,10,SF,61,5,DAL,2,25
28,7,,0,13,.589,21,10,.500,20,11,.440,25,.467,45,5,1.000,5,5,5,176,Caleb Martin,5,14,SF,58,3,MIA,3,18
31,5,,0,26,.524,22,22,.537,41,0,.000,1,.524,42,14,.824,17,4,4,90,Jonas ValanÄiÅ«nas,18,9,C,58,2,NOP,10,44
26,13,,5,17,.364,19,17,.362,47,2,.250,8,.345,55,17,.895,19,4,4,145,Brandon Ingram,1,8,SF,57,4,NOP,9,18
22,7,,13,27,.535,23,23,.535,43,0,,0,.535,43,11,.611,18,15,0,154,Isaiah Jackson,21,24,C,57,3,IND,4,48
27,11,,0,13,.522,19,9,.375,24,10,.455,22,.413,46,8,1.000,8,6,6,187,Terance Mann,17,19,SG,56,0,LAC,5,30
34,3,,0,23,.552,22,13,.520,25,9,.391,23,.458,48,2,.667,3,9,1,138,Marcus Morris,2,8,PF,55,4,CLE,3,25
31,9,,3,34,.490,22,16,.485,33,6,.333,18,.431,51,4,1.000,4,6,6,218,Tobias Harris,9,11,PF,54,1,PHI,3,43
27,4,,0,14,.646,21,10,.625,16,11,.440,25,.512,41,0,,0,6,2,131,Malik Beasley,1,9,SG,53,4,MIL,3,15
24,9,,4,35,.479,19,12,.545,22,7,.280,25,.404,47,8,.727,11,7,5,185,Wendell Carter Jr.,9,20,C,53,5,ORL,5,44
25,10,,1,14,.488,16,8,.471,17,8,.333,24,.390,41,12,1.000,12,4,4,141,Herbert Jones,6,15,SF,52,5,NOP,11,20
22,12,,2,11,.433,21,18,.462,39,3,.231,13,.404,52,6,.857,7,4,4,123,Jaime Jaquez Jr.,2,6,SF,51,3,MIA,7,13
35,33,,4,16,.462,16,12,.429,28,4,.364,11,.410,39,13,.867,15,6,6,210,Patrick Beverley,4,16,PG,49,6,MIL,6,20
32,13,,4,21,.564,16,4,.364,11,12,.429,28,.410,39,4,.667,6,13,0,219,Maxi Kleber,4,20,C,48,3,DAL,5,25
24,5,,12,16,.488,21,21,.525,40,0,.000,3,.488,43,5,.385,13,9,2,184,Precious Achiuwa,22,20,PF,47,4,NYK,4,38
20,11,,3,31,.569,16,7,.500,14,9,.409,22,.444,36,6,.857,7,5,5,128,Nikola JoviÄ,2,9,PF,47,5,MIA,6,33
23,9,,6,23,.479,18,8,.444,18,10,.333,30,.375,48,0,,0,4,4,168,Trey Murphy III,3,12,SF,46,5,NOP,8,26
25,8,,0,7,.588,20,20,.606,33,0,.000,1,.588,34,5,.556,9,7,0,106,Markelle Fultz,7,12,PG,45,3,ORL,8,14
26,3,,9,24,.538,16,6,.500,12,10,.370,27,.410,39,2,1.000,2,7,3,147,Jonathan Isaac,10,7,PF,44,5,ORL,4,34
26,2,,3,20,.472,16,14,.519,27,2,.222,9,.444,36,10,.588,17,7,0,105,Moritz Wagner,11,21,C,44,6,ORL,8,31
21,15,,3,28,.621,16,7,.636,11,9,.409,22,.485,33,3,.750,4,10,0,127,Jaylin Williams,4,11,C,44,4,OKC,3,32
28,12,,1,14,.443,16,9,.375,24,7,.350,20,.364,44,4,.667,6,21,0,144,Dante Exum,3,9,PG,43,3,DAL,5,17
33,12,,1,13,.417,16,8,.320,25,8,.348,23,.333,48,2,1.000,2,12,0,117,Reggie Jackson,2,12,PG,42,2,DEN,8,15
37,24,,4,15,.469,11,3,.375,8,8,.333,24,.344,32,12,.800,15,6,6,175,Kyle Lowry,6,23,PG,42,6,PHI,4,21
20,10,,2,6,.500,16,7,.538,13,9,.321,28,.390,41,1,.500,2,10,0,198,Cason Wallace,7,14,SG,42,9,OKC,4,13
25,4,,0,13,.461,15,10,.417,24,5,.357,14,.395,38,4,.500,8,5,5,152,Rui Hachimura,6,8,PF,39,0,LAL,2,19
28,7,,5,22,.667,14,14,.667,21,0,,0,.667,21,11,.846,13,13,0,133,Luke Kornet,19,11,C,39,1,BOS,6,41
35,8,,5,26,.569,12,3,.429,7,9,.409,22,.414,29,5,.625,8,6,0,170,Nicolas Batum,9,13,PF,38,1,PHI,5,35
35,10,,3,19,.300,13,9,.273,33,4,.235,17,.260,50,8,.615,13,6,0,114,Russell Westbrook,6,11,PG,38,7,LAC,10,25
29,3,,2,11,.500,12,7,.583,12,5,.294,17,.414,29,8,1.000,8,5,0,111,Taurean Prince,1,9,PF,37,1,LAL,1,12
23,9,,1,13,.341,13,11,.393,28,2,.154,13,.317,41,8,.889,9,7,0,103,Cole Anthony,2,16,PG,36,4,ORL,5,15
26,5,,2,8,.536,12,6,.462,13,6,.400,15,.429,28,6,1.000,6,4,0,84,Naji Marshall,3,9,SF,36,2,NOP,2,11
34,4,,0,19,.471,11,0,.000,6,11,.379,29,.314,35,2,.500,4,12,0,150,Justin Holiday,1,16,SG,35,6,DEN,3,20
27,9,,0,10,.517,10,0,.000,2,10,.370,27,.345,29,3,1.000,3,10,0,125,Sam Merrill,2,9,SG,33,0,CLE,0,12
35,5,,2,6,.446,9,2,.182,11,7,.412,17,.321,28,7,.875,8,4,0,118,Eric Gordon,1,5,SG,32,5,PHO,4,7
31,7,,1,10,.750,12,6,.600,10,6,.600,10,.600,20,2,1.000,2,4,1,107,Delon Wright,2,5,PG,32,4,MIA,0,12
29,11,,6,20,.500,13,13,.542,24,0,.000,2,.500,26,5,.455,11,4,4,104,Jusuf NurkiÄ,13,15,C,31,6,PHO,6,33
25,1,,0,4,.917,10,8,.889,9,2,.667,3,.833,12,7,.875,8,7,0,26,Luka Garza,2,0,C,29,0,MIN,0,6
30,4,,2,9,.256,9,6,.333,18,3,.130,23,.220,41,7,.875,8,10,0,121,Georges Niang,3,18,PF,28,4,CLE,7,12
29,7,,4,6,.560,10,2,.286,7,8,.444,18,.400,25,0,,0,5,0,61,Cameron Payne,0,10,PG,28,1,PHI,3,6
31,13,,1,20,.500,11,8,.571,14,3,.273,11,.440,25,2,1.000,2,6,0,124,Pat Connaughton,3,6,SF,27,6,MIL,3,23
29,4,,3,7,.411,8,1,.167,6,7,.318,22,.286,28,2,1.000,2,6,6,159,Gary Harris,5,18,SG,25,7,ORL,2,12
31,7,,0,18,.618,10,9,.692,13,1,.250,4,.588,17,4,.667,6,4,0,84,Larry Nance Jr.,15,9,C,25,2,NOP,7,33
34,4,,1,11,.417,7,1,.111,9,6,.400,15,.292,24,4,.571,7,4,0,51,Bojan BogdanoviÄ,1,3,SF,24,0,NYK,1,12
27,8,,1,12,.411,10,7,.583,12,3,.188,16,.357,28,1,1.000,1,5,0,126,Haywood Highsmith,2,14,PF,24,1,MIA,4,14
32,4,,1,13,.458,11,11,.579,19,0,.000,5,.458,24,2,.667,3,2,2,59,Kawhi Leonard,3,3,SF,24,4,LAC,4,16
31,2,,1,3,.588,7,1,.250,4,6,.462,13,.412,17,2,1.000,2,4,0,51,Buddy Hield,2,4,SG,22,0,PHI,2,5
28,9,,1,5,.317,9,8,.500,16,1,.071,14,.300,30,2,1.000,2,9,0,67,Monte Morris,1,6,PG,21,2,MIN,0,6
30,4,,0,14,.455,7,1,.250,4,6,.333,18,.318,22,0,,0,4,2,104,Royce O'Neale,5,11,SF,20,1,PHO,2,19
33,4,,2,13,.389,7,7,.389,18,0,,0,.389,18,5,.625,8,6,0,66,Mason Plumlee,7,13,C,19,3,LAC,2,20
35,3,,0,0,.441,6,3,.500,6,3,.273,11,.353,17,3,.750,4,3,0,52,Patty Mills,1,2,PG,18,1,MIA,1,1
21,4,,6,13,.313,6,3,.250,12,3,.250,12,.250,24,3,.500,6,10,0,90,Peyton Watson,2,9,SF,18,0,DEN,3,15
26,2,,1,8,.386,7,4,.364,11,3,.273,11,.318,22,0,,0,6,3,112,Amir Coffey,2,6,SF,17,2,LAC,5,10
26,0,,1,4,.583,7,7,.583,12,0,,0,.583,12,3,1.000,3,3,0,37,Drew Eubanks,0,6,C,17,2,PHO,2,4
24,2,,0,9,.438,6,4,.800,5,2,.182,11,.375,16,3,1.000,3,6,0,67,A.J. Green,0,9,SG,17,0,MIL,1,9
25,3,,7,18,.500,7,7,.500,14,0,,0,.500,14,3,.375,8,6,0,115,Mitchell Robinson,23,15,C,17,6,NYK,3,41
25,0,,2,11,.636,6,4,.444,9,2,1.000,2,.545,11,2,.500,4,10,0,55,Oshae Brissett,3,2,SF,16,3,BOS,1,14
30,8,,1,6,.429,5,3,.500,6,2,.250,8,.357,14,3,.500,6,5,0,73,Spencer Dinwiddie,1,7,PG,15,2,LAL,1,7
32,10,,5,10,.438,7,7,.438,16,0,,0,.438,16,1,.500,2,10,0,87,Tristan Thompson,10,9,C,15,1,CLE,2,20
25,2,,0,4,.611,5,4,.667,6,1,.333,3,.556,9,3,.500,6,4,0,29,Josh Okogie,0,7,SG,14,2,PHO,2,4
32,7,,2,1,.591,5,2,.667,3,3,.375,8,.455,11,0,,0,10,0,64,Doug McDermott,2,5,SF,13,0,IND,1,3
29,6,,0,5,.406,5,2,.667,3,3,.231,13,.313,16,0,,0,5,0,60,Duncan Robinson,0,6,SF,13,2,MIA,5,5
23,2,,1,7,.500,3,1,.250,4,2,.500,4,.375,8,5,.625,8,7,0,42,Jalen Smith,7,8,C,13,2,IND,4,14
26,1,,0,3,.714,5,5,1.000,5,0,.000,2,.714,7,2,.667,3,2,0,18,Thomas Bryant,2,1,C,12,0,MIA,2,5
22,10,,1,6,.545,5,3,.600,5,2,.333,6,.455,11,0,,0,5,0,60,Andre Jackson Jr.,5,10,SG,12,5,MIL,3,11
25,3,,3,10,.688,5,4,.571,7,1,1.000,1,.625,8,1,1.000,1,8,0,69,Xavier Tillman Sr.,4,7,PF,12,3,BOS,3,14
35,2,,0,8,.500,4,4,.667,6,0,.000,2,.500,8,3,.750,4,3,0,37,Danilo Gallinari,1,0,SF,11,0,MIL,1,9
23,4,,0,2,.500,3,2,1.000,2,1,.200,5,.429,7,4,1.000,4,3,0,12,Bones Hyland,0,0,PG,11,0,LAC,1,2
36,12,,0,11,.417,4,2,.400,5,2,.286,7,.333,12,1,.500,2,7,0,68,Joe Ingles,2,3,SF,11,3,ORL,0,13
23,0,,1,2,.556,4,2,.667,3,2,.333,6,.444,9,1,.500,2,10,0,30,A.J. Lawson,1,1,SG,11,0,DAL,0,3
38,0,,0,0,.917,4,1,.500,2,3,.750,4,.667,6,0,,0,2,1,31,P.J. Tucker,3,6,PF,11,0,LAC,3,3
27,5,,2,5,.423,4,1,.333,3,3,.300,10,.308,13,0,,0,3,1,63,Dean Wade,1,4,PF,11,1,CLE,2,6
33,2,,2,4,.292,3,2,.400,5,1,.143,7,.250,12,2,1.000,2,4,0,42,Jae Crowder,2,4,PF,9,0,MIL,0,6
35,4,,0,13,.500,4,3,.600,5,1,.250,4,.444,9,0,,0,5,0,32,Kevin Love,1,2,PF,9,0,MIA,2,14
24,2,,3,7,.444,4,4,.444,9,0,,0,.444,9,1,.500,2,6,0,43,Paul Reed,9,7,C,9,1,PHI,3,16
26,0,,0,3,.500,3,1,.333,3,2,.400,5,.375,8,0,,0,4,0,20,DaQuan Jeffries,1,2,SG,8,1,NYK,0,4
26,1,,0,4,.333,3,1,.333,3,2,.222,9,.250,12,0,,0,8,0,32,Svi Mykhailiuk,1,3,SF,8,1,BOS,2,5
20,4,,1,3,.300,3,3,.429,7,0,.000,3,.300,10,2,.667,3,9,0,31,Jarace Walker,1,2,PF,8,2,IND,6,4
28,2,,0,6,.300,1,0,,0,1,.200,5,.200,5,4,1.000,4,2,2,43,Grayson Allen,2,4,SG,7,1,PHO,3,8
25,9,,1,4,.175,3,2,.333,6,1,.071,14,.150,20,0,,0,4,0,62,Jose Alvarado,0,3,PG,7,5,NOP,4,4
23,0,,0,1,.700,3,2,1.000,2,1,.333,3,.600,5,0,,0,4,0,14,Nassir Little,0,2,SF,7,0,PHO,0,1
22,2,,0,2,.500,3,2,.667,3,1,.250,4,.429,7,0,,0,6,0,18,Wendell Moore Jr.,0,3,SG,7,1,MIN,1,2
25,1,,1,5,1.000,2,2,1.000,2,0,,0,1.000,2,3,.750,4,5,0,27,Jericho Sims,3,1,C,7,2,NYK,0,8
21,0,,0,2,.417,2,1,.500,2,1,.250,4,.333,6,2,.500,4,3,0,16,Julian Strawther,0,3,SF,7,1,DEN,1,2
27,3,,0,7,.292,3,2,.400,5,1,.143,7,.250,12,0,,0,5,0,69,Gabe Vincent,1,8,PG,7,2,LAL,3,8
20,2,,0,1,.429,3,3,.600,5,0,.000,2,.429,7,0,,0,2,0,11,Anthony Black,1,1,PG,6,1,ORL,1,2
21,3,,0,4,.333,2,0,.000,4,2,.400,5,.222,9,0,,0,5,0,18,Josh Minott,1,2,SF,6,0,MIN,0,5
25,1,,0,0,.833,2,1,1.000,1,1,.500,2,.667,3,1,1.000,1,2,0,10,Chuma Okeke,0,0,SF,6,0,ORL,0,0
32,3,,0,9,.333,1,1,.333,3,0,,0,.333,3,4,.667,6,13,0,44,Dwight Powell,3,9,C,6,1,DAL,3,12
22,1,,0,1,.500,2,2,.500,4,0,,0,.500,4,1,.500,2,3,0,10,Brandon Boston Jr.,1,2,SF,5,0,LAC,0,2
20,1,,0,1,.833,2,1,.500,2,1,1.000,1,.667,3,0,,0,2,0,10,Jett Howard,0,1,SF,5,0,ORL,2,1
27,2,,0,1,.000,0,0,.000,4,0,.000,2,.000,6,5,.833,6,4,0,22,Shake Milton,0,0,SG,5,1,NYK,0,1
23,0,,1,0,.667,2,2,.667,3,0,,0,.667,3,1,.500,2,3,0,14,Zeke Nnaji,2,1,PF,5,0,DEN,2,2
20,2,,1,3,.333,2,2,.333,6,0,,0,.333,6,0,,0,7,0,25,Kendall Brown,0,2,SG,4,0,IND,3,3
20,0,,0,2,.333,2,2,.500,4,0,.000,2,.333,6,0,,0,3,0,17,Dyson Daniels,0,0,PG,4,2,NOP,1,2
35,0,,1,2,.500,1,1,.500,2,0,,0,.500,2,2,1.000,2,2,0,13,DeAndre Jordan,1,4,C,4,1,DEN,0,3
27,2,,0,4,.222,2,2,.500,4,0,.000,5,.222,9,0,.000,2,6,0,30,Jordan McLaughlin,0,1,PG,4,0,MIN,2,4
24,1,,1,1,.667,2,2,1.000,2,0,.000,1,.667,3,0,,0,3,0,11,Jalen Pickett,0,1,SG,4,0,DEN,0,1
24,0,,1,2,.667,2,2,.667,3,0,,0,.667,3,0,,0,3,0,13,Neemias Queta,1,0,C,4,0,BOS,0,3
21,1,,1,3,.667,2,2,.667,3,0,,0,.667,3,0,,0,4,0,22,Jaden Springer,0,1,PG,4,0,BOS,2,3
29,3,,0,7,.250,2,2,.667,3,0,.000,5,.250,8,0,,0,7,0,32,Kenrich Williams,1,3,PF,4,1,OKC,0,8
23,2,,0,1,.250,1,1,.500,2,0,.000,2,.250,4,1,.500,2,4,0,10,MarJon Beauchamp,0,1,SF,3,0,MIL,1,1
21,0,,0,1,.750,1,0,,0,1,.500,2,.500,2,0,,0,3,0,14,Caleb Houstan,1,0,SF,3,0,ORL,0,2
34,0,,0,4,.300,1,0,.000,2,1,.333,3,.200,5,0,,0,1,0,12,Markieff Morris,0,1,PF,3,0,DAL,1,4
31,0,,0,1,1.500,1,0,,0,1,1.000,1,1.000,1,0,,0,1,0,4,Daniel Theis,0,0,C,3,0,LAC,0,1
24,0,,0,4,.333,1,1,.333,3,0,,0,.333,3,0,,0,3,0,13,Bol Bol,0,2,PF,2,1,PHO,0,4
27,1,,1,3,.000,0,0,.000,1,0,.000,2,.000,3,2,1.000,2,4,0,15,Mamadi Diakite,0,3,PF,2,1,NYK,1,3
20,0,,0,0,.500,1,1,1.000,1,0,.000,1,.500,2,0,,0,4,0,7,Ousmane Dieng,0,0,PF,2,0,OKC,0,0
20,0,,0,0,1.000,1,1,1.000,1,0,,0,1.000,1,0,.000,3,2,0,6,Chris Livingston,0,0,SF,2,0,MIL,0,0
23,1,,0,0,.500,1,1,.500,2,0,,0,.500,2,0,.000,2,1,0,5,Jeremiah Robinson-Earl,1,0,PF,2,0,NOP,0,1
19,0,,0,2,.333,1,1,.500,2,0,.000,1,.333,3,0,,0,3,0,11,Jordan Walsh,0,0,SF,2,0,BOS,0,2
23,1,,0,9,.000,0,0,.000,2,0,,0,.000,2,1,.500,2,4,0,24,Jaxson Hayes,3,7,C,1,0,LAL,2,12
36,0,,0,0,,0,0,,0,0,,0,,0,1,.500,2,1,0,1,James Johnson,0,0,PF,1,0,IND,1,0
23,1,,0,2,.000,0,0,.000,1,0,.000,3,.000,4,1,.500,2,3,0,14,Hunter Tyson,1,0,PF,1,0,DEN,1,3
31,0,,1,0,,0,0,,0,0,,0,,0,0,,0,2,0,5,Thanasis Antetokounmpo,0,1,PF,0,1,MIL,0,0
24,2,,0,2,.000,0,0,.000,2,0,,0,.000,2,0,,0,2,0,10,Goga Bitadze,1,0,C,0,0,ORL,1,3
24,0,,0,1,,0,0,,0,0,,0,,0,0,,0,3,0,10,Kobe Brown,1,1,PF,0,0,LAC,0,2
21,0,,0,2,.000,0,0,.000,1,0,.000,3,.000,4,0,,0,3,0,12,Jordan Hawkins,0,1,SG,0,0,NOP,0,2
33,3,,1,12,.000,0,0,.000,3,0,,0,.000,3,0,,0,7,0,46,Gordon Hayward,1,2,SF,0,1,OKC,0,13
28,2,,1,1,,0,0,,0,0,,0,,0,0,,0,2,0,9,Damian Jones,1,0,C,0,0,CLE,2,2
23,0,,0,1,,0,0,,0,0,,0,,0,0,,0,1,0,3,E.J. Liddell,0,0,PF,0,0,NOP,0,1
25,1,,0,1,.000,0,0,,0,0,.000,2,.000,2,0,,0,1,0,7,De'Anthony Melton,0,1,SG,0,0,PHI,0,1
20,0,,0,3,.000,0,0,,0,0,.000,1,.000,1,0,,0,3,0,7,Leonard Miller,1,0,SF,0,0,MIN,0,4
21,1,,0,3,.000,0,0,.000,2,0,,0,.000,2,0,,0,3,0,9,Olivier-Maxence Prosper,0,0,PF,0,0,DAL,0,3
23,1,,0,1,.000,0,0,,0,0,.000,1,.000,1,0,,0,1,0,2,Orlando Robinson,0,0,C,0,0,MIA,0,1
22,0,,0,0,,0,0,,0,0,,0,,0,0,,0,2,0,3,David Roddy,0,0,PF,0,0,PHO,0,0
26,0,,0,1,.000,0,0,,0,0,.000,1,.000,1,0,,0,1,0,3,Matt Ryan,0,0,SF,0,1,NOP,1,1
34,0,,0,0,.000,0,0,.000,1,0,.000,1,.000,2,0,,0,1,0,4,Isaiah Thomas,0,0,PG,0,0,PHO,1,0
30,1,,0,1,.000,0,0,.000,1,0,.000,1,.000,2,0,,0,3,0,11,T.J. Warren,2,0,SF,0,0,MIN,0,3
26,0,,0,1,.000,0,0,,0,0,.000,1,.000,1,0,,0,3,0,9,Lindy Waters III,0,0,SG,0,0,OKC,0,1
35,0,,0,0,,0,0,,0,0,,0,,0,0,,0,1,0,4,Thaddeus Young,0,0,PF,0,0,PHO,0,0
,,,,,.532,,,.535,,,.351,,.462,,,.779,,,,,League Average,,,,,,,,
